"","Index","Date","Year","Round","Region","wSeed","Winner","WConf","WScore","LSeed","Loser","LConf","LScore","OT","SeD","ScD","Result"
"1",1,"14-Mar-85",1985,"64","East",4,"Loyola Chicago","MVC",59,13,"Iona","MAAC",58,"",-9,1,"4 over 13"
"2",2,"14-Mar-85",1985,"64","West",9,"Arkansas","SEC",63,8,"Iowa","B10",54,"",1,9,"9 over 8"
"3",3,"14-Mar-85",1985,"64","Midwest",4,"Ohio St.","B10",75,13,"Iowa St.","B12",64,"",-9,11,"4 over 13"
"4",4,"14-Mar-85",1985,"64","East",1,"Georgetown","BE",68,16,"Lehigh","Pat",43,"",-15,25,"1 over 16"
"5",5,"14-Mar-85",1985,"64","Southeast",2,"North Carolina","ACC",76,15,"Middle Tennessee","CUSA",57,"",-13,19,"2 over 15"
"6",6,"14-Mar-85",1985,"64","Midwest",1,"Oklahoma","B12",96,16,"North Carolina A&T","MEAC",83,"",-15,13,"1 over 16"
"7",7,"14-Mar-85",1985,"64","Southeast",3,"Kansas","B12",49,14,"Ohio","MAC",38,"",-11,11,"3 over 14"
"8",8,"14-Mar-85",1985,"64","East",5,"SMU","Amer",85,12,"Old Dominion","CUSA",68,"",-7,17,"5 over 12"
"9",9,"14-Mar-85",1985,"64","Southeast",7,"Notre Dame","ACC",79,10,"Oregon St.","P12",70,"",-3,9,"7 over 10"
"10",10,"14-Mar-85",1985,"64","Midwest",5,"Louisiana Tech","CUSA",78,12,"Pittsburgh","ACC",54,"",-7,24,"5 over 12"
"11",11,"14-Mar-85",1985,"64","Southeast",11,"Auburn","SEC",59,6,"Purdue","B10",58,"",5,1,"11 over 6"
"12",12,"14-Mar-85",1985,"64","West",4,"UNLV","MWC",85,13,"San Diego St.","MWC",80,"",-9,5,"4 over 13"
"13",13,"14-Mar-85",1985,"64","West",1,"St. John's","BE",83,16,"Southern","SWAC",59,"",-15,24,"1 over 16"
"14",14,"14-Mar-85",1985,"64","Midwest",9,"Illinois St.","MVC",58,8,"USC","P12",55,"",1,3,"9 over 8"
"15",15,"14-Mar-85",1985,"64","East",8,"Temple","Amer",60,9,"Virginia Tech","ACC",57,"",-1,3,"8 over 9"
"16",16,"14-Mar-85",1985,"64","West",12,"Kentucky","SEC",66,5,"Washington","P12",58,"",7,8,"12 over 5"
"17",17,"15-Mar-85",1985,"64","West",7,"Alabama","SEC",50,10,"Arizona","P12",41,"",-3,9,"7 over 10"
"18",18,"15-Mar-85",1985,"64","Southeast",8,"Villanova","BE",51,9,"Dayton","A10",49,"",-1,2,"8 over 9"
"19",19,"15-Mar-85",1985,"64","East",7,"Syracuse","ACC",70,10,"DePaul","BE",65,"",-3,5,"7 over 10"
"20",20,"15-Mar-85",1985,"64","Southeast",1,"Michigan","B10",59,16,"Fairleigh Dickinson","NEC",55,"",-15,4,"1 over 16"
"21",21,"15-Mar-85",1985,"64","Southeast",13,"Navy","Pat",78,4,"LSU","SEC",55,"",9,23,"13 over 4"
"22",22,"15-Mar-85",1985,"64","West",2,"VCU","A10",81,15,"Marshall","CUSA",65,"",-13,16,"2 over 15"
"23",23,"15-Mar-85",1985,"64","East",2,"Georgia Tech","ACC",65,15,"Mercer","SC",58,"",-13,7,"2 over 15"
"24",24,"15-Mar-85",1985,"64","Southeast",5,"Maryland","B10",69,12,"Miami OH","MAC",68,"1 OT",-7,1,"5 over 12"
"25",25,"15-Mar-85",1985,"64","Midwest",7,"UAB","CUSA",70,10,"Michigan St.","B10",68,"",-3,2,"7 over 10"
"26",26,"15-Mar-85",1985,"64","West",3,"North Carolina St.","ACC",65,14,"Nevada","MWC",56,"",-11,9,"3 over 14"
"27",27,"15-Mar-85",1985,"64","East",3,"Illinois","B10",76,14,"Northeastern","CAA",57,"",-11,19,"3 over 14"
"28",28,"15-Mar-85",1985,"64","Midwest",2,"Memphis","Amer",67,15,"Penn","Ivy",55,"",-13,12,"2 over 15"
"29",29,"15-Mar-85",1985,"64","Midwest",3,"Duke","ACC",75,14,"Pepperdine","WCC",62,"",-11,13,"3 over 14"
"30",30,"15-Mar-85",1985,"64","Midwest",11,"Boston College","ACC",55,6,"Texas Tech","B12",53,"",5,2,"11 over 6"
"31",31,"15-Mar-85",1985,"64","West",11,"UTEP","CUSA",79,6,"Tulsa","Amer",75,"",5,4,"11 over 6"
"32",32,"15-Mar-85",1985,"64","East",6,"Georgia","SEC",67,11,"Wichita St.","MVC",59,"",-5,8,"6 over 11"
"33",33,"16-Mar-85",1985,"32","West",1,"St. John's","BE",68,9,"Arkansas","SEC",65,"",-8,3,"1 over 9"
"34",34,"16-Mar-85",1985,"32","Midwest",1,"Oklahoma","B12",75,9,"Illinois St.","MVC",69,"",-8,6,"1 over 9"
"35",35,"16-Mar-85",1985,"32","Southeast",11,"Auburn","SEC",66,3,"Kansas","B12",64,"",8,2,"11 over 3"
"36",36,"16-Mar-85",1985,"32","Southeast",2,"North Carolina","ACC",60,7,"Notre Dame","ACC",58,"",-5,2,"2 over 7"
"37",37,"16-Mar-85",1985,"32","Midwest",5,"Louisiana Tech","CUSA",79,4,"Ohio St.","B10",67,"",1,12,"5 over 4"
"38",38,"16-Mar-85",1985,"32","East",4,"Loyola Chicago","MVC",70,5,"SMU","Amer",57,"",-1,13,"4 over 5"
"39",39,"16-Mar-85",1985,"32","East",1,"Georgetown","BE",63,8,"Temple","Amer",46,"",-7,17,"1 over 8"
"40",40,"16-Mar-85",1985,"32","West",12,"Kentucky","SEC",64,4,"UNLV","MWC",61,"",8,3,"12 over 4"
"41",41,"17-Mar-85",1985,"32","Midwest",11,"Boston College","ACC",74,3,"Duke","ACC",73,"",8,1,"11 over 3"
"42",42,"17-Mar-85",1985,"32","East",3,"Illinois","B10",74,6,"Georgia","SEC",58,"",-3,16,"3 over 6"
"43",43,"17-Mar-85",1985,"32","Southeast",8,"Villanova","BE",59,1,"Michigan","B10",55,"",7,4,"8 over 1"
"44",44,"17-Mar-85",1985,"32","Southeast",5,"Maryland","B10",64,13,"Navy","Pat",59,"",-8,5,"5 over 13"
"45",45,"17-Mar-85",1985,"32","East",2,"Georgia Tech","ACC",70,7,"Syracuse","ACC",53,"",-5,17,"2 over 7"
"46",46,"17-Mar-85",1985,"32","Midwest",2,"Memphis","Amer",67,7,"UAB","CUSA",66,"1 OT",-5,1,"2 over 7"
"47",47,"17-Mar-85",1985,"32","West",3,"North Carolina St.","ACC",86,11,"UTEP","CUSA",73,"",-8,13,"3 over 11"
"48",48,"17-Mar-85",1985,"32","West",7,"Alabama","SEC",63,2,"VCU","A10",59,"",5,4,"7 over 2"
"49",49,"21-Mar-85",1985,"16","Midwest",2,"Memphis","Amer",59,11,"Boston College","ACC",57,"",-9,2,"2 over 11"
"50",50,"21-Mar-85",1985,"16","East",2,"Georgia Tech","ACC",61,3,"Illinois","B10",53,"",-1,8,"2 over 3"
"51",51,"21-Mar-85",1985,"16","Midwest",1,"Oklahoma","B12",86,5,"Louisiana Tech","CUSA",84,"1 OT",-4,2,"1 over 5"
"52",52,"21-Mar-85",1985,"16","East",1,"Georgetown","BE",65,4,"Loyola Chicago","MVC",53,"",-3,12,"1 over 4"
"53",53,"22-Mar-85",1985,"16","West",3,"North Carolina St.","ACC",61,7,"Alabama","SEC",55,"",-4,6,"3 over 7"
"54",54,"22-Mar-85",1985,"16","Southeast",2,"North Carolina","ACC",62,11,"Auburn","SEC",56,"",-9,6,"2 over 11"
"55",55,"22-Mar-85",1985,"16","West",1,"St. John's","BE",86,12,"Kentucky","SEC",70,"",-11,16,"1 over 12"
"56",56,"22-Mar-85",1985,"16","Southeast",8,"Villanova","BE",46,5,"Maryland","B10",43,"",3,3,"8 over 5"
"57",57,"23-Mar-85",1985,"8","East",1,"Georgetown","BE",60,2,"Georgia Tech","ACC",54,"",-1,6,"1 over 2"
"58",58,"23-Mar-85",1985,"8","Midwest",2,"Memphis","Amer",63,1,"Oklahoma","B12",61,"",1,2,"2 over 1"
"59",59,"24-Mar-85",1985,"8","Southeast",8,"Villanova","BE",56,2,"North Carolina","ACC",44,"",6,12,"8 over 2"
"60",60,"24-Mar-85",1985,"8","West",1,"St. John's","BE",69,3,"North Carolina St.","ACC",60,"",-2,9,"1 over 3"
"61",61,"30-Mar-85",1985,"4","Final Four",8,"Villanova","BE",52,2,"Memphis","Amer",45,"",6,7,"8 over 2"
"62",62,"30-Mar-85",1985,"4","Final Four",1,"Georgetown","BE",77,1,"St. John's","BE",59,"",0,18,"1 over 1"
"63",63,"1-Apr-85",1985,"Champ","Championship",8,"Villanova","BE",66,1,"Georgetown","BE",64,"",7,2,"8 over 1"
"64",64,"13-Mar-86",1986,"64","Southeast",3,"Memphis","Amer",95,14,"Ball St.","MAC",63,"",-11,32,"3 over 14"
"65",65,"13-Mar-86",1986,"64","West",2,"Louisville","ACC",93,15,"Drexel","CAA",73,"",-13,20,"2 over 15"
"66",66,"13-Mar-86",1986,"64","Midwest",9,"Temple","Amer",61,8,"Jacksonville","ASun",50,"1 OT",1,11,"9 over 8"
"67",67,"13-Mar-86",1986,"64","Southeast",2,"Georgia Tech","ACC",68,15,"Marist","MAAC",53,"",-13,15,"2 over 15"
"68",68,"13-Mar-86",1986,"64","East",1,"Duke","ACC",85,16,"Mississippi Valley",NA,78,"",-15,7,"1 over 16"
"69",69,"13-Mar-86",1986,"64","West",6,"UAB","CUSA",66,11,"Missouri","SEC",64,"",-5,2,"6 over 11"
"70",70,"13-Mar-86",1986,"64","Midwest",1,"Kansas","B12",71,16,"North Carolina A&T","MEAC",46,"",-15,25,"1 over 16"
"71",71,"13-Mar-86",1986,"64","East",4,"Oklahoma","B12",80,13,"Northeastern","CAA",74,"",-9,6,"4 over 13"
"72",72,"13-Mar-86",1986,"64","Southeast",11,"LSU","SEC",94,6,"Purdue","B10",87,"2 OT",5,7,"11 over 6"
"73",73,"13-Mar-86",1986,"64","Midwest",4,"Georgetown","BE",70,13,"Texas Tech","B12",64,"",-9,6,"4 over 13"
"74",74,"13-Mar-86",1986,"64","West",3,"North Carolina","ACC",84,14,"Utah","P12",72,"",-11,12,"3 over 14"
"75",75,"13-Mar-86",1986,"64","West",7,"Bradley","MVC",83,10,"UTEP","CUSA",65,"",-3,18,"7 over 10"
"76",76,"13-Mar-86",1986,"64","East",12,"DePaul","BE",72,5,"Virginia","ACC",68,"",7,4,"12 over 5"
"77",77,"13-Mar-86",1986,"64","Southeast",10,"Villanova","BE",71,7,"Virginia Tech","ACC",62,"",3,9,"10 over 7"
"78",78,"13-Mar-86",1986,"64","Midwest",5,"Michigan St.","B10",72,12,"Washington","P12",70,"",-7,2,"5 over 12"
"79",79,"13-Mar-86",1986,"64","East",8,"Old Dominion","CUSA",72,9,"West Virginia","B12",64,"",-1,8,"8 over 9"
"80",80,"14-Mar-86",1986,"64","Midwest",2,"Michigan","B10",70,15,"Akron","MAC",64,"",-13,6,"2 over 15"
"81",81,"14-Mar-86",1986,"64","West",8,"Auburn","SEC",73,9,"Arizona","P12",63,"",-1,10,"8 over 9"
"82",82,"14-Mar-86",1986,"64","East",2,"Syracuse","ACC",101,15,"Brown","Ivy",52,"",-13,49,"2 over 15"
"83",83,"14-Mar-86",1986,"64","Southeast",1,"Kentucky","SEC",75,16,"Davidson","A10",55,"",-15,20,"1 over 16"
"84",84,"14-Mar-86",1986,"64","Southeast",4,"Illinois","B10",75,13,"Fairfield","MAAC",51,"",-9,24,"4 over 13"
"85",85,"14-Mar-86",1986,"64","East",14,"Cleveland St.","Horz",83,3,"Indiana","B10",79,"",11,4,"14 over 3"
"86",86,"14-Mar-86",1986,"64","Midwest",6,"North Carolina St.","ACC",66,11,"Iowa","B10",64,"",-5,2,"6 over 11"
"87",87,"14-Mar-86",1986,"64","West",4,"UNLV","MWC",74,13,"Louisiana Monroe","SB",51,"",-9,23,"4 over 13"
"88",88,"14-Mar-86",1986,"64","Midwest",7,"Iowa St.","B12",81,10,"Miami OH","MAC",79,"1 OT",-3,2,"7 over 10"
"89",89,"14-Mar-86",1986,"64","West",1,"St. John's","BE",83,16,"Montana St.","BSky",74,"",-15,9,"1 over 16"
"90",90,"14-Mar-86",1986,"64","Southeast",8,"Western Kentucky","CUSA",67,9,"Nebraska","B10",59,"",-1,8,"8 over 9"
"91",91,"14-Mar-86",1986,"64","Midwest",14,"Arkansas Little Rock","SB",90,3,"Notre Dame","ACC",83,"",11,7,"14 over 3"
"92",92,"14-Mar-86",1986,"64","West",5,"Maryland","B10",69,12,"Pepperdine","WCC",64,"",-7,5,"5 over 12"
"93",93,"14-Mar-86",1986,"64","East",6,"Saint Joseph's","A10",60,11,"Richmond","A10",59,"",-5,1,"6 over 11"
"94",94,"14-Mar-86",1986,"64","East",7,"Navy","Pat",87,10,"Tulsa","Amer",68,"",-3,19,"7 over 10"
"95",95,"14-Mar-86",1986,"64","Southeast",5,"Alabama","SEC",97,12,"Xavier","BE",80,"",-7,17,"5 over 12"
"96",96,"15-Mar-86",1986,"32","West",2,"Louisville","ACC",82,7,"Bradley","MVC",68,"",-5,14,"2 over 7"
"97",97,"15-Mar-86",1986,"32","Midwest",5,"Michigan St.","B10",80,4,"Georgetown","BE",68,"",1,12,"5 over 4"
"98",98,"15-Mar-86",1986,"32","Southeast",11,"LSU","SEC",83,3,"Memphis","Amer",81,"",8,2,"11 over 3"
"99",99,"15-Mar-86",1986,"32","East",12,"DePaul","BE",74,4,"Oklahoma","B12",69,"",8,5,"12 over 4"
"100",100,"15-Mar-86",1986,"32","East",1,"Duke","ACC",89,8,"Old Dominion","CUSA",61,"",-7,28,"1 over 8"
"101",101,"15-Mar-86",1986,"32","Midwest",1,"Kansas","B12",65,9,"Temple","Amer",43,"",-8,22,"1 over 9"
"102",102,"15-Mar-86",1986,"32","West",3,"North Carolina","ACC",77,6,"UAB","CUSA",59,"",-3,18,"3 over 6"
"103",103,"15-Mar-86",1986,"32","Southeast",2,"Georgia Tech","ACC",66,10,"Villanova","BE",61,"",-8,5,"2 over 10"
"104",104,"16-Mar-86",1986,"32","Midwest",6,"North Carolina St.","ACC",80,14,"Arkansas Little Rock","SB",66,"2 OT",-8,14,"6 over 14"
"105",105,"16-Mar-86",1986,"32","Southeast",5,"Alabama","SEC",58,4,"Illinois","B10",56,"",1,2,"5 over 4"
"106",106,"16-Mar-86",1986,"32","West",4,"UNLV","MWC",70,5,"Maryland","B10",64,"",-1,6,"4 over 5"
"107",107,"16-Mar-86",1986,"32","Midwest",7,"Iowa St.","B12",72,2,"Michigan","B10",69,"",5,3,"7 over 2"
"108",108,"16-Mar-86",1986,"32","East",14,"Cleveland St.","Horz",75,6,"Saint Joseph's","A10",69,"",8,6,"14 over 6"
"109",109,"16-Mar-86",1986,"32","West",8,"Auburn","SEC",81,1,"St. John's","BE",65,"",7,16,"8 over 1"
"110",110,"16-Mar-86",1986,"32","East",7,"Navy","Pat",97,2,"Syracuse","ACC",85,"",5,12,"7 over 2"
"111",111,"16-Mar-86",1986,"32","Southeast",1,"Kentucky","SEC",71,8,"Western Kentucky","CUSA",64,"",-7,7,"1 over 8"
"112",112,"20-Mar-86",1986,"16","Southeast",1,"Kentucky","SEC",68,5,"Alabama","SEC",63,"",-4,5,"1 over 5"
"113",113,"20-Mar-86",1986,"16","Southeast",11,"LSU","SEC",70,2,"Georgia Tech","ACC",64,"",9,6,"11 over 2"
"114",114,"20-Mar-86",1986,"16","West",2,"Louisville","ACC",94,3,"North Carolina","ACC",79,"",-1,15,"2 over 3"
"115",115,"20-Mar-86",1986,"16","West",8,"Auburn","SEC",70,4,"UNLV","MWC",63,"",4,7,"8 over 4"
"116",116,"21-Mar-86",1986,"16","East",7,"Navy","Pat",71,14,"Cleveland St.","Horz",70,"",-7,1,"7 over 14"
"117",117,"21-Mar-86",1986,"16","East",1,"Duke","ACC",74,12,"DePaul","BE",67,"",-11,7,"1 over 12"
"118",118,"21-Mar-86",1986,"16","Midwest",6,"North Carolina St.","ACC",70,7,"Iowa St.","B12",66,"",-1,4,"6 over 7"
"119",119,"21-Mar-86",1986,"16","Midwest",1,"Kansas","B12",96,5,"Michigan St.","B10",86,"1 OT",-4,10,"1 over 5"
"120",120,"22-Mar-86",1986,"8","West",2,"Louisville","ACC",84,8,"Auburn","SEC",76,"",-6,8,"2 over 8"
"121",121,"22-Mar-86",1986,"8","Southeast",11,"LSU","SEC",59,1,"Kentucky","SEC",57,"",10,2,"11 over 1"
"122",122,"23-Mar-86",1986,"8","East",1,"Duke","ACC",71,7,"Navy","Pat",50,"",-6,21,"1 over 7"
"123",123,"23-Mar-86",1986,"8","Midwest",1,"Kansas","B12",75,6,"North Carolina St.","ACC",67,"",-5,8,"1 over 6"
"124",124,"29-Mar-86",1986,"4","Final Four",1,"Duke","ACC",71,1,"Kansas","B12",67,"",0,4,"1 over 1"
"125",125,"29-Mar-86",1986,"4","Final Four",2,"Louisville","ACC",88,11,"LSU","SEC",77,"",-9,11,"2 over 11"
"126",126,"31-Mar-86",1986,"Champ","Championship",2,"Louisville","ACC",72,1,"Duke","ACC",69,"",1,3,"2 over 1"
"127",127,"12-Mar-87",1987,"64","Southeast",7,"New Orleans","Slnd",83,10,"BYU","WCC",79,"",-3,4,"7 over 10"
"128",128,"12-Mar-87",1987,"64","West",4,"UCLA","P12",92,13,"Central Michigan","MAC",73,"",-9,19,"4 over 13"
"129",129,"12-Mar-87",1987,"64","Midwest",1,"Indiana","B10",92,16,"Fairfield","MAAC",58,"",-15,34,"1 over 16"
"130",130,"12-Mar-87",1987,"64","West",9,"Kansas St.","B12",82,8,"Georgia","SEC",79,"1 OT",1,3,"9 over 8"
"131",131,"12-Mar-87",1987,"64","West",1,"UNLV","MWC",95,16,"Idaho St.","BSky",70,"",-15,25,"1 over 16"
"132",132,"12-Mar-87",1987,"64","Southeast",14,"Austin Peay","OVC",68,3,"Illinois","B10",67,"",11,1,"14 over 3"
"133",133,"12-Mar-87",1987,"64","East",4,"TCU","B12",76,13,"Marshall","CUSA",60,"",-9,16,"4 over 13"
"134",134,"12-Mar-87",1987,"64","East",5,"Notre Dame","ACC",84,12,"Middle Tennessee","CUSA",71,"",-7,13,"5 over 12"
"135",135,"12-Mar-87",1987,"64","Midwest",13,"Xavier","BE",70,4,"Missouri","SEC",69,"",9,1,"13 over 4"
"136",136,"12-Mar-87",1987,"64","East",9,"Michigan","B10",97,8,"Navy","Pat",82,"",1,15,"9 over 8"
"137",137,"12-Mar-87",1987,"64","Southeast",2,"Alabama","SEC",88,15,"North Carolina A&T","MEAC",71,"",-13,17,"2 over 15"
"138",138,"12-Mar-87",1987,"64","East",1,"North Carolina","ACC",113,16,"Penn","Ivy",82,"",-15,31,"1 over 16"
"139",139,"12-Mar-87",1987,"64","Midwest",8,"Auburn","SEC",62,9,"San Diego","WCC",61,"",-1,1,"8 over 9"
"140",140,"12-Mar-87",1987,"64","Midwest",5,"Duke","ACC",58,12,"Texas A&M","SEC",51,"",-7,7,"5 over 12"
"141",141,"12-Mar-87",1987,"64","Southeast",6,"Providence","BE",90,11,"UAB","CUSA",68,"",-5,22,"6 over 11"
"142",142,"12-Mar-87",1987,"64","West",12,"Wyoming","MWC",64,5,"Virginia","ACC",60,"",7,4,"12 over 5"
"143",143,"13-Mar-87",1987,"64","West",7,"UTEP","CUSA",98,10,"Arizona","P12",91,"1 OT",-3,7,"7 over 10"
"144",144,"13-Mar-87",1987,"64","Southeast",1,"Georgetown","BE",75,16,"Bucknell","Pat",53,"",-15,22,"1 over 16"
"145",145,"13-Mar-87",1987,"64","Southeast",13,"Missouri St.","MVC",65,4,"Clemson","ACC",60,"",9,5,"13 over 4"
"146",146,"13-Mar-87",1987,"64","East",2,"Syracuse","ACC",79,15,"Georgia Southern","SB",73,"",-13,6,"2 over 15"
"147",147,"13-Mar-87",1987,"64","Midwest",10,"LSU","SEC",85,7,"Georgia Tech","ACC",79,"",3,6,"10 over 7"
"148",148,"13-Mar-87",1987,"64","Southeast",5,"Kansas","B12",66,12,"Houston","Amer",55,"",-7,11,"5 over 12"
"149",149,"13-Mar-87",1987,"64","Southeast",9,"Ohio St.","B10",91,8,"Kentucky","SEC",77,"",1,14,"9 over 8"
"150",150,"13-Mar-87",1987,"64","Midwest",3,"DePaul","BE",76,14,"Louisiana Tech","CUSA",62,"",-11,14,"3 over 14"
"151",151,"13-Mar-87",1987,"64","West",3,"Pittsburgh","ACC",93,14,"Marist","MAAC",68,"",-11,25,"3 over 14"
"152",152,"13-Mar-87",1987,"64","East",6,"Florida","SEC",82,11,"North Carolina St.","ACC",70,"",-5,12,"6 over 11"
"153",153,"13-Mar-87",1987,"64","East",3,"Purdue","B10",104,14,"Northeastern","CAA",95,"",-11,9,"3 over 14"
"154",154,"13-Mar-87",1987,"64","West",2,"Iowa","B10",99,15,"Santa Clara","WCC",76,"",-13,23,"2 over 15"
"155",155,"13-Mar-87",1987,"64","Midwest",2,"Temple","Amer",75,15,"Southern","SWAC",56,"",-13,19,"2 over 15"
"156",156,"13-Mar-87",1987,"64","West",6,"Oklahoma","B12",74,11,"Tulsa","Amer",69,"",-5,5,"6 over 11"
"157",157,"13-Mar-87",1987,"64","East",10,"Western Kentucky","CUSA",64,7,"West Virginia","B12",62,"",3,2,"10 over 7"
"158",158,"13-Mar-87",1987,"64","Midwest",6,"St. John's","BE",57,11,"Wichita St.","MVC",55,"",-5,2,"6 over 11"
"159",159,"14-Mar-87",1987,"32","Midwest",1,"Indiana","B10",107,8,"Auburn","SEC",90,"",-7,17,"1 over 8"
"160",160,"14-Mar-87",1987,"32","Southeast",6,"Providence","BE",90,14,"Austin Peay","OVC",87,"1 OT",-8,3,"6 over 14"
"161",161,"14-Mar-87",1987,"32","West",1,"UNLV","MWC",80,9,"Kansas St.","B12",61,"",-8,19,"1 over 9"
"162",162,"14-Mar-87",1987,"32","East",1,"North Carolina","ACC",109,9,"Michigan","B10",97,"",-8,12,"1 over 9"
"163",163,"14-Mar-87",1987,"32","Southeast",2,"Alabama","SEC",101,7,"New Orleans","Slnd",76,"",-5,25,"2 over 7"
"164",164,"14-Mar-87",1987,"32","East",5,"Notre Dame","ACC",58,4,"TCU","B12",57,"",1,1,"5 over 4"
"165",165,"14-Mar-87",1987,"32","West",12,"Wyoming","MWC",78,4,"UCLA","P12",68,"",8,10,"12 over 4"
"166",166,"14-Mar-87",1987,"32","Midwest",5,"Duke","ACC",65,13,"Xavier","BE",60,"",-8,5,"5 over 13"
"167",167,"15-Mar-87",1987,"32","Southeast",5,"Kansas","B12",67,13,"Missouri St.","MVC",63,"",-8,4,"5 over 13"
"168",168,"15-Mar-87",1987,"32","Southeast",1,"Georgetown","BE",82,9,"Ohio St.","B10",79,"",-8,3,"1 over 9"
"169",169,"15-Mar-87",1987,"32","West",6,"Oklahoma","B12",96,3,"Pittsburgh","ACC",93,"",3,3,"6 over 3"
"170",170,"15-Mar-87",1987,"32","East",6,"Florida","SEC",85,3,"Purdue","B10",66,"",3,19,"6 over 3"
"171",171,"15-Mar-87",1987,"32","Midwest",3,"DePaul","BE",83,6,"St. John's","BE",75,"1 OT",-3,8,"3 over 6"
"172",172,"15-Mar-87",1987,"32","Midwest",10,"LSU","SEC",72,2,"Temple","Amer",62,"",8,10,"10 over 2"
"173",173,"15-Mar-87",1987,"32","West",2,"Iowa","B10",84,7,"UTEP","CUSA",82,"",-5,2,"2 over 7"
"174",174,"15-Mar-87",1987,"32","East",2,"Syracuse","ACC",104,10,"Western Kentucky","CUSA",86,"",-8,18,"2 over 10"
"175",175,"19-Mar-87",1987,"16","Southeast",6,"Providence","BE",103,2,"Alabama","SEC",82,"",4,21,"6 over 2"
"176",176,"19-Mar-87",1987,"16","East",2,"Syracuse","ACC",87,6,"Florida","SEC",81,"",-4,6,"2 over 6"
"177",177,"19-Mar-87",1987,"16","Southeast",1,"Georgetown","BE",70,5,"Kansas","B12",57,"",-4,13,"1 over 5"
"178",178,"19-Mar-87",1987,"16","East",1,"North Carolina","ACC",74,5,"Notre Dame","ACC",68,"",-4,6,"1 over 5"
"179",179,"20-Mar-87",1987,"16","Midwest",10,"LSU","SEC",63,3,"DePaul","BE",58,"",7,5,"10 over 3"
"180",180,"20-Mar-87",1987,"16","Midwest",1,"Indiana","B10",88,5,"Duke","ACC",82,"",-4,6,"1 over 5"
"181",181,"20-Mar-87",1987,"16","West",2,"Iowa","B10",93,6,"Oklahoma","B12",91,"1 OT",-4,2,"2 over 6"
"182",182,"20-Mar-87",1987,"16","West",1,"UNLV","MWC",92,12,"Wyoming","MWC",78,"",-11,14,"1 over 12"
"183",183,"21-Mar-87",1987,"8","Southeast",6,"Providence","BE",88,1,"Georgetown","BE",73,"",5,15,"6 over 1"
"184",184,"21-Mar-87",1987,"8","East",2,"Syracuse","ACC",79,1,"North Carolina","ACC",75,"",1,4,"2 over 1"
"185",185,"22-Mar-87",1987,"8","West",1,"UNLV","MWC",84,2,"Iowa","B10",81,"",-1,3,"1 over 2"
"186",186,"22-Mar-87",1987,"8","Midwest",1,"Indiana","B10",77,10,"LSU","SEC",76,"",-9,1,"1 over 10"
"187",187,"28-Mar-87",1987,"4","Final Four",2,"Syracuse","ACC",77,6,"Providence","BE",63,"",-4,14,"2 over 6"
"188",188,"28-Mar-87",1987,"4","Final Four",1,"Indiana","B10",97,1,"UNLV","MWC",93,"",0,4,"1 over 1"
"189",189,"30-Mar-87",1987,"Champ","Championship",1,"Indiana","B10",74,2,"Syracuse","ACC",73,"",-1,1,"1 over 2"
"190",190,"17-Mar-88",1988,"64","Midwest",9,"Memphis","Amer",75,8,"Baylor","B12",60,"",1,15,"9 over 8"
"191",191,"17-Mar-88",1988,"64","West",3,"Michigan","B10",63,14,"Boise St.","MWC",58,"",-11,5,"3 over 14"
"192",192,"17-Mar-88",1988,"64","East",2,"Duke","ACC",85,15,"Boston University","Pat",69,"",-13,16,"2 over 15"
"193",193,"17-Mar-88",1988,"64","Southeast",8,"Auburn","SEC",90,9,"Bradley","MVC",86,"",-1,4,"8 over 9"
"194",194,"17-Mar-88",1988,"64","Southeast",4,"BYU","WCC",98,13,"Charlotte","CUSA",92,"1 OT",-9,6,"4 over 13"
"195",195,"17-Mar-88",1988,"64","Southeast",1,"Oklahoma","B12",94,16,"Chattanooga","SC",66,"",-15,28,"1 over 16"
"196",196,"17-Mar-88",1988,"64","Midwest",1,"Purdue","B10",94,16,"Fairleigh Dickinson","NEC",79,"",-15,15,"1 over 16"
"197",197,"17-Mar-88",1988,"64","Midwest",4,"Kansas St.","B12",66,13,"La Salle","A10",53,"",-9,13,"4 over 13"
"198",198,"17-Mar-88",1988,"64","East",11,"Rhode Island","A10",87,6,"Missouri","SEC",80,"",5,7,"11 over 6"
"199",199,"17-Mar-88",1988,"64","East",3,"Syracuse","ACC",69,14,"North Carolina A&T","MEAC",55,"",-11,14,"3 over 14"
"200",200,"17-Mar-88",1988,"64","West",2,"North Carolina","ACC",83,15,"North Texas","CUSA",65,"",-13,18,"2 over 15"
"201",201,"17-Mar-88",1988,"64","East",7,"SMU","Amer",83,10,"Notre Dame","ACC",75,"",-3,8,"7 over 10"
"202",202,"17-Mar-88",1988,"64","Southeast",5,"Louisville","ACC",70,12,"Oregon St.","P12",61,"",-7,9,"5 over 12"
"203",203,"17-Mar-88",1988,"64","West",6,"Florida","SEC",62,11,"St. John's","BE",59,"",-5,3,"6 over 11"
"204",204,"17-Mar-88",1988,"64","Midwest",5,"DePaul","BE",83,12,"Wichita St.","MVC",62,"",-7,21,"5 over 12"
"205",205,"17-Mar-88",1988,"64","West",10,"Loyola Marymount","WCC",119,7,"Wyoming","MWC",115,"",3,4,"10 over 7"
"206",206,"18-Mar-88",1988,"64","Southeast",6,"Villanova","BE",82,11,"Arkansas","SEC",74,"",-5,8,"6 over 11"
"207",207,"18-Mar-88",1988,"64","West",1,"Arizona","P12",90,16,"Cornell","Ivy",50,"",-15,40,"1 over 16"
"208",208,"18-Mar-88",1988,"64","Midwest",2,"Pittsburgh","ACC",108,15,"Eastern Michigan","MAC",90,"",-13,18,"2 over 15"
"209",209,"18-Mar-88",1988,"64","West",5,"Iowa","B10",102,12,"Florida St.","ACC",98,"",-7,4,"5 over 12"
"210",210,"18-Mar-88",1988,"64","East",13,"Richmond","A10",72,4,"Indiana","B10",69,"",9,3,"13 over 4"
"211",211,"18-Mar-88",1988,"64","East",5,"Georgia Tech","ACC",90,12,"Iowa St.","B12",78,"",-7,12,"5 over 12"
"212",212,"18-Mar-88",1988,"64","East",1,"Temple","Amer",87,16,"Lehigh","Pat",73,"",-15,14,"1 over 16"
"213",213,"18-Mar-88",1988,"64","East",8,"Georgetown","BE",66,9,"LSU","SEC",63,"",-1,3,"8 over 9"
"214",214,"18-Mar-88",1988,"64","West",4,"UNLV","MWC",54,13,"Missouri St.","MVC",50,"",-9,4,"4 over 13"
"215",215,"18-Mar-88",1988,"64","Midwest",14,"Murray St.","OVC",78,3,"North Carolina St.","ACC",75,"",11,3,"14 over 3"
"216",216,"18-Mar-88",1988,"64","Southeast",2,"Kentucky","SEC",99,15,"Southern","SWAC",84,"",-13,15,"2 over 15"
"217",217,"18-Mar-88",1988,"64","Southeast",7,"Maryland","B10",92,10,"UC Santa Barbara","BW",82,"",-3,10,"7 over 10"
"218",218,"18-Mar-88",1988,"64","Midwest",7,"Vanderbilt","SEC",80,10,"Utah St.","MWC",77,"",-3,3,"7 over 10"
"219",219,"18-Mar-88",1988,"64","West",8,"Seton Hall","BE",80,9,"UTEP","CUSA",64,"",-1,16,"8 over 9"
"220",220,"18-Mar-88",1988,"64","Southeast",3,"Illinois","B10",81,14,"UTSA","CUSA",72,"",-11,9,"3 over 14"
"221",221,"18-Mar-88",1988,"64","Midwest",6,"Kansas","B12",85,11,"Xavier","BE",72,"",-5,13,"6 over 11"
"222",222,"19-Mar-88",1988,"32","Southeast",1,"Oklahoma","B12",107,8,"Auburn","SEC",87,"",-7,20,"1 over 8"
"223",223,"19-Mar-88",1988,"32","Southeast",5,"Louisville","ACC",97,4,"BYU","WCC",76,"",1,21,"5 over 4"
"224",224,"19-Mar-88",1988,"32","Midwest",4,"Kansas St.","B12",66,5,"DePaul","BE",58,"",-1,8,"4 over 5"
"225",225,"19-Mar-88",1988,"32","West",3,"Michigan","B10",108,6,"Florida","SEC",85,"",-3,23,"3 over 6"
"226",226,"19-Mar-88",1988,"32","West",2,"North Carolina","ACC",123,10,"Loyola Marymount","WCC",97,"",-8,26,"2 over 10"
"227",227,"19-Mar-88",1988,"32","Midwest",1,"Purdue","B10",100,9,"Memphis","Amer",73,"",-8,27,"1 over 9"
"228",228,"19-Mar-88",1988,"32","East",2,"Duke","ACC",94,7,"SMU","Amer",79,"",-5,15,"2 over 7"
"229",229,"19-Mar-88",1988,"32","East",11,"Rhode Island","A10",97,3,"Syracuse","ACC",94,"",8,3,"11 over 3"
"230",230,"20-Mar-88",1988,"32","East",1,"Temple","Amer",74,8,"Georgetown","BE",53,"",-7,21,"1 over 8"
"231",231,"20-Mar-88",1988,"32","East",13,"Richmond","A10",59,5,"Georgia Tech","ACC",55,"",8,4,"13 over 5"
"232",232,"20-Mar-88",1988,"32","Southeast",6,"Villanova","BE",66,3,"Illinois","B10",63,"",3,3,"6 over 3"
"233",233,"20-Mar-88",1988,"32","Southeast",2,"Kentucky","SEC",90,7,"Maryland","B10",81,"",-5,9,"2 over 7"
"234",234,"20-Mar-88",1988,"32","Midwest",6,"Kansas","B12",61,14,"Murray St.","OVC",58,"",-8,3,"6 over 14"
"235",235,"20-Mar-88",1988,"32","Midwest",7,"Vanderbilt","SEC",80,2,"Pittsburgh","ACC",74,"1 OT",5,6,"7 over 2"
"236",236,"20-Mar-88",1988,"32","West",1,"Arizona","P12",84,8,"Seton Hall","BE",55,"",-7,29,"1 over 8"
"237",237,"20-Mar-88",1988,"32","West",5,"Iowa","B10",104,4,"UNLV","MWC",86,"",1,18,"5 over 4"
"238",238,"24-Mar-88",1988,"16","Southeast",6,"Villanova","BE",80,2,"Kentucky","SEC",74,"",4,6,"6 over 2"
"239",239,"24-Mar-88",1988,"16","Southeast",1,"Oklahoma","B12",108,5,"Louisville","ACC",98,"",-4,10,"1 over 5"
"240",240,"24-Mar-88",1988,"16","East",2,"Duke","ACC",73,11,"Rhode Island","A10",72,"",-9,1,"2 over 11"
"241",241,"24-Mar-88",1988,"16","East",1,"Temple","Amer",69,13,"Richmond","A10",47,"",-12,22,"1 over 13"
"242",242,"25-Mar-88",1988,"16","West",1,"Arizona","P12",99,5,"Iowa","B10",79,"",-4,20,"1 over 5"
"243",243,"25-Mar-88",1988,"16","West",2,"North Carolina","ACC",78,3,"Michigan","B10",69,"",-1,9,"2 over 3"
"244",244,"25-Mar-88",1988,"16","Midwest",4,"Kansas St.","B12",73,1,"Purdue","B10",70,"",3,3,"4 over 1"
"245",245,"25-Mar-88",1988,"16","Midwest",6,"Kansas","B12",77,7,"Vanderbilt","SEC",64,"",-1,13,"6 over 7"
"246",246,"26-Mar-88",1988,"8","East",2,"Duke","ACC",63,1,"Temple","Amer",53,"",1,10,"2 over 1"
"247",247,"26-Mar-88",1988,"8","Southeast",1,"Oklahoma","B12",78,6,"Villanova","BE",59,"",-5,19,"1 over 6"
"248",248,"27-Mar-88",1988,"8","Midwest",6,"Kansas","B12",71,4,"Kansas St.","B12",58,"",2,13,"6 over 4"
"249",249,"27-Mar-88",1988,"8","West",1,"Arizona","P12",70,2,"North Carolina","ACC",52,"",-1,18,"1 over 2"
"250",250,"2-Apr-88",1988,"4","Final Four",1,"Oklahoma","B12",86,1,"Arizona","P12",78,"",0,8,"1 over 1"
"251",251,"2-Apr-88",1988,"4","Final Four",6,"Kansas","B12",66,2,"Duke","ACC",59,"",4,7,"6 over 2"
"252",252,"4-Apr-88",1988,"Champ","Championship",6,"Kansas","B12",83,1,"Oklahoma","B12",79,"",5,4,"6 over 1"
"253",253,"16-Mar-89",1989,"64","Midwest",4,"Louisville","ACC",76,13,"Arkansas Little Rock","SB",71,"",-9,5,"4 over 13"
"254",254,"16-Mar-89",1989,"64","Southeast",1,"Oklahoma","B12",72,16,"East Tennessee St.","SC",71,"",-15,1,"1 over 16"
"255",255,"16-Mar-89",1989,"64","Southeast",13,"Middle Tennessee","CUSA",97,4,"Florida St.","ACC",83,"",9,14,"13 over 4"
"256",256,"16-Mar-89",1989,"64","West",4,"UNLV","MWC",68,13,"Idaho","BSky",56,"",-9,12,"4 over 13"
"257",257,"16-Mar-89",1989,"64","East",11,"Minnesota","B10",86,6,"Kansas St.","B12",75,"",5,11,"11 over 6"
"258",258,"16-Mar-89",1989,"64","Southeast",9,"Louisiana Tech","CUSA",83,8,"La Salle","A10",74,"",1,9,"9 over 8"
"259",259,"16-Mar-89",1989,"64","Midwest",5,"Arkansas","SEC",120,12,"Loyola Marymount","WCC",101,"",-7,19,"5 over 12"
"260",260,"16-Mar-89",1989,"64","Midwest",1,"Illinois","B10",77,16,"McNeese St.","Slnd",71,"",-15,6,"1 over 16"
"261",261,"16-Mar-89",1989,"64","West",12,"DePaul","BE",66,5,"Memphis","Amer",63,"",7,3,"12 over 5"
"262",262,"16-Mar-89",1989,"64","Midwest",9,"Ball St.","MAC",68,8,"Pittsburgh","ACC",64,"",1,4,"9 over 8"
"263",263,"16-Mar-89",1989,"64","Southeast",5,"Virginia","ACC",100,12,"Providence","BE",97,"",-7,3,"5 over 12"
"264",264,"16-Mar-89",1989,"64","West",1,"Arizona","P12",94,16,"Robert Morris","NEC",60,"",-15,34,"1 over 16"
"265",265,"16-Mar-89",1989,"64","West",9,"Clemson","ACC",83,8,"Saint Mary's","WCC",70,"",1,13,"9 over 8"
"266",266,"16-Mar-89",1989,"64","East",2,"Duke","ACC",90,15,"South Carolina St.","MEAC",69,"",-13,21,"2 over 15"
"267",267,"16-Mar-89",1989,"64","East",14,"Siena","MAAC",80,3,"Stanford","P12",78,"",11,2,"14 over 3"
"268",268,"16-Mar-89",1989,"64","East",7,"West Virginia","B12",84,10,"Tennessee","SEC",68,"",-3,16,"7 over 10"
"269",269,"17-Mar-89",1989,"64","Southeast",11,"South Alabama","SB",86,6,"Alabama","SEC",84,"",5,2,"11 over 6"
"270",270,"17-Mar-89",1989,"64","Midwest",2,"Syracuse","ACC",104,15,"Bucknell","Pat",81,"",-13,23,"2 over 15"
"271",271,"17-Mar-89",1989,"64","Midwest",3,"Missouri","SEC",85,14,"Creighton","BE",69,"",-11,16,"3 over 14"
"272",272,"17-Mar-89",1989,"64","Midwest",10,"Colorado St.","MWC",68,7,"Florida","SEC",46,"",3,22,"10 over 7"
"273",273,"17-Mar-89",1989,"64","West",2,"Indiana","B10",99,15,"George Mason","A10",85,"",-13,14,"2 over 15"
"274",274,"17-Mar-89",1989,"64","Midwest",11,"Texas","B12",76,6,"Georgia Tech","ACC",70,"",5,6,"11 over 6"
"275",275,"17-Mar-89",1989,"64","Southeast",7,"UCLA","P12",84,10,"Iowa St.","B12",74,"",-3,10,"7 over 10"
"276",276,"17-Mar-89",1989,"64","West",7,"UTEP","CUSA",85,10,"LSU","SEC",74,"",-3,11,"7 over 10"
"277",277,"17-Mar-89",1989,"64","West",3,"Seton Hall","BE",60,14,"Missouri St.","MVC",51,"",-11,9,"3 over 14"
"278",278,"17-Mar-89",1989,"64","West",11,"Evansville","MVC",94,6,"Oregon St.","P12",90,"1 OT",5,4,"11 over 6"
"279",279,"17-Mar-89",1989,"64","East",1,"Georgetown","BE",50,16,"Princeton","Ivy",49,"",-15,1,"1 over 16"
"280",280,"17-Mar-89",1989,"64","East",4,"Iowa","B10",87,13,"Rutgers","B10",73,"",-9,14,"4 over 13"
"281",281,"17-Mar-89",1989,"64","East",5,"North Carolina St.","ACC",81,12,"South Carolina","SEC",66,"",-7,15,"5 over 12"
"282",282,"17-Mar-89",1989,"64","Southeast",2,"North Carolina","ACC",93,15,"Southern","SWAC",79,"",-13,14,"2 over 15"
"283",283,"17-Mar-89",1989,"64","East",9,"Notre Dame","ACC",81,8,"Vanderbilt","SEC",65,"",1,16,"9 over 8"
"284",284,"17-Mar-89",1989,"64","Southeast",3,"Michigan","B10",92,14,"Xavier","BE",87,"",-11,5,"3 over 14"
"285",285,"18-Mar-89",1989,"32","Midwest",4,"Louisville","ACC",93,5,"Arkansas","SEC",84,"",-1,9,"4 over 5"
"286",286,"18-Mar-89",1989,"32","Midwest",1,"Illinois","B10",72,9,"Ball St.","MAC",60,"",-8,12,"1 over 9"
"287",287,"18-Mar-89",1989,"32","West",1,"Arizona","P12",94,9,"Clemson","ACC",68,"",-8,26,"1 over 9"
"288",288,"18-Mar-89",1989,"32","West",4,"UNLV","MWC",85,12,"DePaul","BE",70,"",-8,15,"4 over 12"
"289",289,"18-Mar-89",1989,"32","Southeast",1,"Oklahoma","B12",124,9,"Louisiana Tech","CUSA",81,"",-8,43,"1 over 9"
"290",290,"18-Mar-89",1989,"32","Southeast",5,"Virginia","ACC",104,13,"Middle Tennessee","CUSA",88,"",-8,16,"5 over 13"
"291",291,"18-Mar-89",1989,"32","East",11,"Minnesota","B10",80,14,"Siena","MAAC",67,"",-3,13,"11 over 14"
"292",292,"18-Mar-89",1989,"32","East",2,"Duke","ACC",70,7,"West Virginia","B12",63,"",-5,7,"2 over 7"
"293",293,"19-Mar-89",1989,"32","Midwest",2,"Syracuse","ACC",65,10,"Colorado St.","MWC",50,"",-8,15,"2 over 10"
"294",294,"19-Mar-89",1989,"32","West",3,"Seton Hall","BE",87,11,"Evansville","MVC",73,"",-8,14,"3 over 11"
"295",295,"19-Mar-89",1989,"32","East",5,"North Carolina St.","ACC",102,4,"Iowa","B10",96,"2 OT",1,6,"5 over 4"
"296",296,"19-Mar-89",1989,"32","East",1,"Georgetown","BE",81,9,"Notre Dame","ACC",74,"",-8,7,"1 over 9"
"297",297,"19-Mar-89",1989,"32","Southeast",3,"Michigan","B10",91,11,"South Alabama","SB",82,"",-8,9,"3 over 11"
"298",298,"19-Mar-89",1989,"32","Midwest",3,"Missouri","SEC",108,11,"Texas","B12",89,"",-8,19,"3 over 11"
"299",299,"19-Mar-89",1989,"32","Southeast",2,"North Carolina","ACC",88,7,"UCLA","P12",81,"",-5,7,"2 over 7"
"300",300,"19-Mar-89",1989,"32","West",2,"Indiana","B10",92,7,"UTEP","CUSA",69,"",-5,23,"2 over 7"
"301",301,"23-Mar-89",1989,"16","West",4,"UNLV","MWC",68,1,"Arizona","P12",67,"",3,1,"4 over 1"
"302",302,"23-Mar-89",1989,"16","West",3,"Seton Hall","BE",78,2,"Indiana","B10",65,"",1,13,"3 over 2"
"303",303,"23-Mar-89",1989,"16","Southeast",3,"Michigan","B10",92,2,"North Carolina","ACC",87,"",1,5,"3 over 2"
"304",304,"23-Mar-89",1989,"16","Southeast",5,"Virginia","ACC",86,1,"Oklahoma","B12",80,"",4,6,"5 over 1"
"305",305,"24-Mar-89",1989,"16","Midwest",1,"Illinois","B10",83,4,"Louisville","ACC",69,"",-3,14,"1 over 4"
"306",306,"24-Mar-89",1989,"16","East",2,"Duke","ACC",87,11,"Minnesota","B10",70,"",-9,17,"2 over 11"
"307",307,"24-Mar-89",1989,"16","Midwest",2,"Syracuse","ACC",83,3,"Missouri","SEC",80,"",-1,3,"2 over 3"
"308",308,"24-Mar-89",1989,"16","East",1,"Georgetown","BE",69,5,"North Carolina St.","ACC",61,"",-4,8,"1 over 5"
"309",309,"25-Mar-89",1989,"8","West",3,"Seton Hall","BE",84,4,"UNLV","MWC",61,"",-1,23,"3 over 4"
"310",310,"25-Mar-89",1989,"8","Southeast",3,"Michigan","B10",102,5,"Virginia","ACC",65,"",-2,37,"3 over 5"
"311",311,"26-Mar-89",1989,"8","East",2,"Duke","ACC",85,1,"Georgetown","BE",77,"",1,8,"2 over 1"
"312",312,"26-Mar-89",1989,"8","Midwest",1,"Illinois","B10",89,2,"Syracuse","ACC",86,"",-1,3,"1 over 2"
"313",313,"1-Apr-89",1989,"4","Final Four",3,"Seton Hall","BE",95,2,"Duke","ACC",78,"",1,17,"3 over 2"
"314",314,"1-Apr-89",1989,"4","Final Four",3,"Michigan","B10",83,1,"Illinois","B10",81,"",2,2,"3 over 1"
"315",315,"3-Apr-89",1989,"Champ","Championship",3,"Michigan","B10",80,3,"Seton Hall","BE",79,"1 OT",0,1,"3 over 3"
"316",316,"15-Mar-90",1990,"64","West",1,"UNLV","MWC",102,16,"Arkansas Little Rock","SB",72,"",-15,30,"1 over 16"
"317",317,"15-Mar-90",1990,"64","East",1,"Connecticut","Amer",76,16,"Boston University","Pat",52,"",-15,24,"1 over 16"
"318",318,"15-Mar-90",1990,"64","East",5,"Clemson","ACC",49,12,"BYU","WCC",47,"",-7,2,"5 over 12"
"319",319,"15-Mar-90",1990,"64","Southeast",4,"Georgia Tech","ACC",99,13,"East Tennessee St.","SC",83,"",-9,16,"4 over 13"
"320",320,"15-Mar-90",1990,"64","Southeast",9,"UC Santa Barbara","BW",70,8,"Houston","Amer",66,"",1,4,"9 over 8"
"321",321,"15-Mar-90",1990,"64","West",4,"Louisville","ACC",78,13,"Idaho","BSky",59,"",-9,19,"4 over 13"
"322",322,"15-Mar-90",1990,"64","Midwest",12,"Dayton","A10",88,5,"Illinois","B10",86,"",7,2,"12 over 5"
"323",323,"15-Mar-90",1990,"64","East",9,"California","P12",65,8,"Indiana","B10",63,"",1,2,"9 over 8"
"324",324,"15-Mar-90",1990,"64","Midwest",8,"North Carolina","ACC",83,9,"Missouri St.","MVC",70,"",-1,13,"8 over 9"
"325",325,"15-Mar-90",1990,"64","Southeast",1,"Michigan St.","B10",75,16,"Murray St.","OVC",71,"1 OT",-15,4,"1 over 16"
"326",326,"15-Mar-90",1990,"64","West",12,"Ball St.","MAC",54,5,"Oregon St.","P12",53,"",7,1,"12 over 5"
"327",327,"15-Mar-90",1990,"64","Midwest",4,"Arkansas","SEC",68,13,"Princeton","Ivy",64,"",-9,4,"4 over 13"
"328",328,"15-Mar-90",1990,"64","West",8,"Ohio St.","B10",84,9,"Providence","BE",83,"1 OT",-1,1,"8 over 9"
"329",329,"15-Mar-90",1990,"64","East",4,"La Salle","A10",79,13,"Southern Mississippi",NA,63,"",-9,16,"4 over 13"
"330",330,"15-Mar-90",1990,"64","Midwest",1,"Oklahoma","B12",77,16,"Towson","CAA",68,"",-15,9,"1 over 16"
"331",331,"15-Mar-90",1990,"64","Southeast",5,"LSU","SEC",70,12,"Villanova","BE",63,"",-7,7,"5 over 12"
"332",332,"16-Mar-90",1990,"64","West",7,"Alabama","SEC",71,10,"Colorado St.","MWC",54,"",-3,17,"7 over 10"
"333",333,"16-Mar-90",1990,"64","Southeast",2,"Syracuse","ACC",70,15,"Coppin St.","MEAC",48,"",-13,22,"2 over 15"
"334",334,"16-Mar-90",1990,"64","Midwest",10,"Texas","B12",100,7,"Georgia","SEC",88,"",3,12,"10 over 7"
"335",335,"16-Mar-90",1990,"64","West",3,"Michigan","B10",76,14,"Illinois St.","MVC",70,"",-11,6,"3 over 14"
"336",336,"16-Mar-90",1990,"64","Midwest",6,"Xavier","BE",87,11,"Kansas St.","B12",79,"",-5,8,"6 over 11"
"337",337,"16-Mar-90",1990,"64","Midwest",2,"Purdue","B10",75,15,"Louisiana Monroe","SB",63,"",-13,12,"2 over 15"
"338",338,"16-Mar-90",1990,"64","Southeast",14,"Northern Iowa","MVC",74,3,"Missouri","SEC",71,"",11,3,"14 over 3"
"339",339,"16-Mar-90",1990,"64","West",11,"Loyola Marymount","WCC",111,6,"New Mexico St.","WAC",92,"",5,19,"11 over 6"
"340",340,"16-Mar-90",1990,"64","Southeast",7,"Virginia","ACC",75,10,"Notre Dame","ACC",67,"",-3,8,"7 over 10"
"341",341,"16-Mar-90",1990,"64","East",3,"Duke","ACC",81,14,"Richmond","A10",46,"",-11,35,"3 over 14"
"342",342,"16-Mar-90",1990,"64","East",2,"Kansas","B12",79,15,"Robert Morris","NEC",71,"",-13,8,"2 over 15"
"343",343,"16-Mar-90",1990,"64","West",2,"Arizona","P12",79,15,"South Florida","Amer",67,"",-13,12,"2 over 15"
"344",344,"16-Mar-90",1990,"64","East",6,"St. John's","BE",81,11,"Temple","Amer",65,"",-5,16,"6 over 11"
"345",345,"16-Mar-90",1990,"64","Midwest",3,"Georgetown","BE",70,14,"Texas Southern","SWAC",52,"",-11,18,"3 over 14"
"346",346,"16-Mar-90",1990,"64","East",7,"UCLA","P12",68,10,"UAB","CUSA",56,"",-3,12,"7 over 10"
"347",347,"16-Mar-90",1990,"64","Southeast",6,"Minnesota","B10",64,11,"UTEP","CUSA",61,"1 OT",-5,3,"6 over 11"
"348",348,"17-Mar-90",1990,"32","East",1,"Connecticut","Amer",74,9,"California","P12",54,"",-8,20,"1 over 9"
"349",349,"17-Mar-90",1990,"32","Midwest",4,"Arkansas","SEC",86,12,"Dayton","A10",84,"",-8,2,"4 over 12"
"350",350,"17-Mar-90",1990,"32","East",5,"Clemson","ACC",79,4,"La Salle","A10",75,"",1,4,"5 over 4"
"351",351,"17-Mar-90",1990,"32","West",12,"Ball St.","MAC",62,4,"Louisville","ACC",60,"",8,2,"12 over 4"
"352",352,"17-Mar-90",1990,"32","Southeast",4,"Georgia Tech","ACC",94,5,"LSU","SEC",91,"",-1,3,"4 over 5"
"353",353,"17-Mar-90",1990,"32","West",1,"UNLV","MWC",76,8,"Ohio St.","B10",65,"",-7,11,"1 over 8"
"354",354,"17-Mar-90",1990,"32","Midwest",8,"North Carolina","ACC",79,1,"Oklahoma","B12",77,"",7,2,"8 over 1"
"355",355,"17-Mar-90",1990,"32","Southeast",1,"Michigan St.","B10",62,9,"UC Santa Barbara","BW",58,"",-8,4,"1 over 9"
"356",356,"18-Mar-90",1990,"32","West",7,"Alabama","SEC",77,2,"Arizona","P12",55,"",5,22,"7 over 2"
"357",357,"18-Mar-90",1990,"32","Midwest",6,"Xavier","BE",74,3,"Georgetown","BE",71,"",3,3,"6 over 3"
"358",358,"18-Mar-90",1990,"32","East",7,"UCLA","P12",71,2,"Kansas","B12",70,"",5,1,"7 over 2"
"359",359,"18-Mar-90",1990,"32","West",11,"Loyola Marymount","WCC",149,3,"Michigan","B10",115,"",8,34,"11 over 3"
"360",360,"18-Mar-90",1990,"32","Southeast",6,"Minnesota","B10",81,14,"Northern Iowa","MVC",78,"",-8,3,"6 over 14"
"361",361,"18-Mar-90",1990,"32","Midwest",10,"Texas","B12",73,2,"Purdue","B10",72,"",8,1,"10 over 2"
"362",362,"18-Mar-90",1990,"32","East",3,"Duke","ACC",76,6,"St. John's","BE",72,"",-3,4,"3 over 6"
"363",363,"18-Mar-90",1990,"32","Southeast",2,"Syracuse","ACC",63,7,"Virginia","ACC",61,"",-5,2,"2 over 7"
"364",364,"22-Mar-90",1990,"16","East",1,"Connecticut","Amer",71,5,"Clemson","ACC",70,"",-4,1,"1 over 5"
"365",365,"22-Mar-90",1990,"16","Midwest",4,"Arkansas","SEC",96,8,"North Carolina","ACC",73,"",-4,23,"4 over 8"
"366",366,"22-Mar-90",1990,"16","East",3,"Duke","ACC",90,7,"UCLA","P12",81,"",-4,9,"3 over 7"
"367",367,"22-Mar-90",1990,"16","Midwest",10,"Texas","B12",102,6,"Xavier","BE",89,"",4,13,"10 over 6"
"368",368,"23-Mar-90",1990,"16","West",11,"Loyola Marymount","WCC",62,7,"Alabama","SEC",60,"",4,2,"11 over 7"
"369",369,"23-Mar-90",1990,"16","West",1,"UNLV","MWC",69,12,"Ball St.","MAC",67,"",-11,2,"1 over 12"
"370",370,"23-Mar-90",1990,"16","Southeast",4,"Georgia Tech","ACC",81,1,"Michigan St.","B10",80,"1 OT",3,1,"4 over 1"
"371",371,"23-Mar-90",1990,"16","Southeast",6,"Minnesota","B10",82,2,"Syracuse","ACC",75,"",4,7,"6 over 2"
"372",372,"24-Mar-90",1990,"8","East",3,"Duke","ACC",79,1,"Connecticut","Amer",78,"1 OT",2,1,"3 over 1"
"373",373,"24-Mar-90",1990,"8","Midwest",4,"Arkansas","SEC",88,10,"Texas","B12",85,"",-6,3,"4 over 10"
"374",374,"25-Mar-90",1990,"8","West",1,"UNLV","MWC",131,11,"Loyola Marymount","WCC",101,"",-10,30,"1 over 11"
"375",375,"25-Mar-90",1990,"8","Southeast",4,"Georgia Tech","ACC",93,6,"Minnesota","B10",91,"",-2,2,"4 over 6"
"376",376,"31-Mar-90",1990,"4","Final Four",3,"Duke","ACC",97,4,"Arkansas","SEC",83,"",-1,14,"3 over 4"
"377",377,"31-Mar-90",1990,"4","Final Four",1,"UNLV","MWC",90,4,"Georgia Tech","ACC",81,"",-3,9,"1 over 4"
"378",378,"2-Apr-90",1990,"Champ","Championship",1,"UNLV","MWC",103,3,"Duke","ACC",73,"",-2,30,"1 over 3"
"379",379,"14-Mar-91",1991,"64","Southeast",2,"Indiana","B10",79,15,"Coastal Carolina","SB",69,"",-13,10,"2 over 15"
"380",380,"14-Mar-91",1991,"64","Midwest",7,"Iowa","B10",76,10,"East Tennessee St.","SC",73,"",-3,3,"7 over 10"
"381",381,"14-Mar-91",1991,"64","Southeast",6,"Pittsburgh","ACC",76,11,"Georgia","SEC",68,"1 OT",-5,8,"6 over 11"
"382",382,"14-Mar-91",1991,"64","Midwest",2,"Duke","ACC",102,15,"Louisiana Monroe","SB",73,"",-13,29,"2 over 15"
"383",383,"14-Mar-91",1991,"64","Midwest",11,"Connecticut","Amer",79,6,"LSU","SEC",62,"",5,17,"11 over 6"
"384",384,"14-Mar-91",1991,"64","Midwest",14,"Xavier","BE",89,3,"Nebraska","B10",84,"",11,5,"14 over 3"
"385",385,"14-Mar-91",1991,"64","East",3,"Oklahoma St.","B12",67,14,"New Mexico","MWC",54,"",-11,13,"3 over 14"
"386",386,"14-Mar-91",1991,"64","West",11,"Creighton","BE",64,6,"New Mexico St.","WAC",56,"",5,8,"11 over 6"
"387",387,"14-Mar-91",1991,"64","Southeast",3,"Kansas","B12",55,14,"New Orleans","Slnd",49,"",-11,6,"3 over 14"
"388",388,"14-Mar-91",1991,"64","West",3,"Seton Hall","BE",71,14,"Pepperdine","WCC",51,"",-11,20,"3 over 14"
"389",389,"14-Mar-91",1991,"64","East",10,"Temple","Amer",80,7,"Purdue","B10",63,"",3,17,"10 over 7"
"390",390,"14-Mar-91",1991,"64","East",6,"North Carolina St.","ACC",114,11,"Southern Mississippi",NA,85,"",-5,29,"6 over 11"
"391",391,"14-Mar-91",1991,"64","West",2,"Arizona","P12",93,15,"St. Francis, Penn",NA,80,"",-13,13,"2 over 15"
"392",392,"14-Mar-91",1991,"64","East",15,"Richmond","A10",73,2,"Syracuse","ACC",69,"",13,4,"15 over 2"
"393",393,"14-Mar-91",1991,"64","Southeast",7,"Florida St.","ACC",75,10,"USC","P12",72,"",-3,3,"7 over 10"
"394",394,"14-Mar-91",1991,"64","West",10,"BYU","WCC",61,7,"Virginia","ACC",48,"",3,13,"10 over 7"
"395",395,"15-Mar-91",1991,"64","Midwest",8,"Georgia Tech","ACC",87,9,"DePaul","BE",70,"",-1,17,"8 over 9"
"396",396,"15-Mar-91",1991,"64","Southeast",1,"Arkansas","SEC",117,16,"Georgia St.","SB",76,"",-15,41,"1 over 16"
"397",397,"15-Mar-91",1991,"64","West",5,"Michigan St.","B10",60,12,"Green Bay","Horz",58,"",-7,2,"5 over 12"
"398",398,"15-Mar-91",1991,"64","Southeast",5,"Wake Forest","ACC",71,12,"Louisiana Tech","CUSA",65,"",-7,6,"5 over 12"
"399",399,"15-Mar-91",1991,"64","East",12,"Eastern Michigan","MAC",76,5,"Mississippi St.","SEC",56,"",7,20,"12 over 5"
"400",400,"15-Mar-91",1991,"64","West",1,"UNLV","MWC",99,16,"Montana","BSky",65,"",-15,34,"1 over 16"
"401",401,"15-Mar-91",1991,"64","Southeast",4,"Alabama","SEC",89,13,"Murray St.","OVC",79,"",-9,10,"4 over 13"
"402",402,"15-Mar-91",1991,"64","East",1,"North Carolina","ACC",101,16,"Northeastern","CAA",66,"",-15,35,"1 over 16"
"403",403,"15-Mar-91",1991,"64","Midwest",4,"St. John's","BE",75,13,"Northern Illinois","MAC",68,"",-9,7,"4 over 13"
"404",404,"15-Mar-91",1991,"64","East",9,"Villanova","BE",50,8,"Princeton","Ivy",48,"",1,2,"9 over 8"
"405",405,"15-Mar-91",1991,"64","Southeast",8,"Arizona St.","P12",79,9,"Rutgers","B10",76,"",-1,3,"8 over 9"
"406",406,"15-Mar-91",1991,"64","West",4,"Utah","P12",82,13,"South Alabama","SB",72,"",-9,10,"4 over 13"
"407",407,"15-Mar-91",1991,"64","Midwest",5,"Texas","B12",73,12,"St. Peter's",NA,65,"",-7,8,"5 over 12"
"408",408,"15-Mar-91",1991,"64","Midwest",1,"Ohio St.","B10",97,16,"Towson","CAA",86,"",-15,11,"1 over 16"
"409",409,"15-Mar-91",1991,"64","East",13,"Penn St.","B10",74,4,"UCLA","P12",69,"",9,5,"13 over 4"
"410",410,"15-Mar-91",1991,"64","West",8,"Georgetown","BE",70,9,"Vanderbilt","SEC",60,"",-1,10,"8 over 9"
"411",411,"16-Mar-91",1991,"32","West",2,"Arizona","P12",76,10,"BYU","WCC",61,"",-8,15,"2 over 10"
"412",412,"16-Mar-91",1991,"32","West",3,"Seton Hall","BE",81,11,"Creighton","BE",69,"",-8,12,"3 over 11"
"413",413,"16-Mar-91",1991,"32","Southeast",2,"Indiana","B10",82,7,"Florida St.","ACC",60,"",-5,22,"2 over 7"
"414",414,"16-Mar-91",1991,"32","Midwest",2,"Duke","ACC",85,7,"Iowa","B10",70,"",-5,15,"2 over 7"
"415",415,"16-Mar-91",1991,"32","East",3,"Oklahoma St.","B12",73,6,"North Carolina St.","ACC",64,"",-3,9,"3 over 6"
"416",416,"16-Mar-91",1991,"32","Southeast",3,"Kansas","B12",77,6,"Pittsburgh","ACC",66,"",-3,11,"3 over 6"
"417",417,"16-Mar-91",1991,"32","East",10,"Temple","Amer",77,15,"Richmond","A10",64,"",-5,13,"10 over 15"
"418",418,"16-Mar-91",1991,"32","Midwest",11,"Connecticut","Amer",66,14,"Xavier","BE",50,"",-3,16,"11 over 14"
"419",419,"17-Mar-91",1991,"32","Southeast",1,"Arkansas","SEC",97,8,"Arizona St.","P12",90,"",-7,7,"1 over 8"
"420",420,"17-Mar-91",1991,"32","West",1,"UNLV","MWC",62,8,"Georgetown","BE",54,"",-7,8,"1 over 8"
"421",421,"17-Mar-91",1991,"32","Midwest",1,"Ohio St.","B10",65,8,"Georgia Tech","ACC",61,"",-7,4,"1 over 8"
"422",422,"17-Mar-91",1991,"32","West",4,"Utah","P12",85,5,"Michigan St.","B10",84,"2 OT",-1,1,"4 over 5"
"423",423,"17-Mar-91",1991,"32","East",12,"Eastern Michigan","MAC",71,13,"Penn St.","B10",68,"1 OT",-1,3,"12 over 13"
"424",424,"17-Mar-91",1991,"32","Midwest",4,"St. John's","BE",84,5,"Texas","B12",76,"",-1,8,"4 over 5"
"425",425,"17-Mar-91",1991,"32","East",1,"North Carolina","ACC",84,9,"Villanova","BE",69,"",-8,15,"1 over 9"
"426",426,"17-Mar-91",1991,"32","Southeast",4,"Alabama","SEC",96,5,"Wake Forest","ACC",88,"",-1,8,"4 over 5"
"427",427,"21-Mar-91",1991,"16","Southeast",1,"Arkansas","SEC",93,4,"Alabama","SEC",70,"",-3,23,"1 over 4"
"428",428,"21-Mar-91",1991,"16","West",3,"Seton Hall","BE",81,2,"Arizona","P12",77,"",1,4,"3 over 2"
"429",429,"21-Mar-91",1991,"16","Southeast",3,"Kansas","B12",83,2,"Indiana","B10",65,"",1,18,"3 over 2"
"430",430,"21-Mar-91",1991,"16","West",1,"UNLV","MWC",83,4,"Utah","P12",66,"",-3,17,"1 over 4"
"431",431,"22-Mar-91",1991,"16","Midwest",2,"Duke","ACC",81,11,"Connecticut","Amer",67,"",-9,14,"2 over 11"
"432",432,"22-Mar-91",1991,"16","East",1,"North Carolina","ACC",93,12,"Eastern Michigan","MAC",67,"",-11,26,"1 over 12"
"433",433,"22-Mar-91",1991,"16","Midwest",4,"St. John's","BE",91,1,"Ohio St.","B10",74,"",3,17,"4 over 1"
"434",434,"22-Mar-91",1991,"16","East",10,"Temple","Amer",72,3,"Oklahoma St.","B12",63,"1 OT",7,9,"10 over 3"
"435",435,"23-Mar-91",1991,"8","Southeast",3,"Kansas","B12",93,1,"Arkansas","SEC",81,"",2,12,"3 over 1"
"436",436,"23-Mar-91",1991,"8","West",1,"UNLV","MWC",77,3,"Seton Hall","BE",65,"",-2,12,"1 over 3"
"437",437,"24-Mar-91",1991,"8","Midwest",2,"Duke","ACC",78,4,"St. John's","BE",61,"",-2,17,"2 over 4"
"438",438,"24-Mar-91",1991,"8","East",1,"North Carolina","ACC",75,10,"Temple","Amer",72,"",-9,3,"1 over 10"
"439",439,"30-Mar-91",1991,"4","Final Four",3,"Kansas","B12",79,1,"North Carolina","ACC",73,"",2,6,"3 over 1"
"440",440,"30-Mar-91",1991,"4","Final Four",2,"Duke","ACC",79,1,"UNLV","MWC",77,"",1,2,"2 over 1"
"441",441,"1-Apr-91",1991,"Champ","Championship",2,"Duke","ACC",72,3,"Kansas","B12",65,"",-1,7,"2 over 3"
"442",442,"19-Mar-92",1992,"64","West",7,"LSU","SEC",94,10,"BYU","WCC",83,"",-3,11,"7 over 10"
"443",443,"19-Mar-92",1992,"64","East",1,"Duke","ACC",82,16,"Campbell","BSth",56,"",-15,26,"1 over 16"
"444",444,"19-Mar-92",1992,"64","West",2,"Indiana","B10",94,15,"Eastern Illinois","OVC",55,"",-13,39,"2 over 15"
"445",445,"19-Mar-92",1992,"64","Midwest",7,"Georgia Tech","ACC",65,10,"Houston","Amer",60,"",-3,5,"7 over 10"
"446",446,"19-Mar-92",1992,"64","East",4,"Seton Hall","BE",78,13,"La Salle","A10",76,"",-9,2,"4 over 13"
"447",447,"19-Mar-92",1992,"64","Midwest",2,"USC","P12",84,15,"Louisiana Monroe","SB",54,"",-13,30,"2 over 15"
"448",448,"19-Mar-92",1992,"64","Southeast",4,"North Carolina","ACC",68,13,"Miami OH","MAC",63,"",-9,5,"4 over 13"
"449",449,"19-Mar-92",1992,"64","Southeast",1,"Ohio St.","B10",83,16,"Mississippi Valley",NA,56,"",-15,27,"1 over 16"
"450",450,"19-Mar-92",1992,"64","West",3,"Florida St.","ACC",78,14,"Montana","BSky",68,"",-11,10,"3 over 14"
"451",451,"19-Mar-92",1992,"64","Midwest",3,"Arkansas","SEC",80,14,"Murray St.","OVC",69,"",-11,11,"3 over 14"
"452",452,"19-Mar-92",1992,"64","Southeast",9,"Connecticut","Amer",86,8,"Nebraska","B10",65,"",1,21,"9 over 8"
"453",453,"19-Mar-92",1992,"64","Midwest",6,"Memphis","Amer",80,11,"Pepperdine","WCC",70,"",-5,10,"6 over 11"
"454",454,"19-Mar-92",1992,"64","West",6,"Georgetown","BE",75,11,"South Florida","Amer",60,"",-5,15,"6 over 11"
"455",455,"19-Mar-92",1992,"64","Southeast",5,"Alabama","SEC",80,12,"Stanford","P12",75,"",-7,5,"5 over 12"
"456",456,"19-Mar-92",1992,"64","East",9,"Iowa","B10",98,8,"Texas","B12",92,"",1,6,"9 over 8"
"457",457,"19-Mar-92",1992,"64","East",5,"Missouri","SEC",89,12,"West Virginia","B12",78,"",-7,11,"5 over 12"
"458",458,"20-Mar-92",1992,"64","Southeast",14,"East Tennessee St.","SC",87,3,"Arizona","P12",80,"",11,7,"14 over 3"
"459",459,"20-Mar-92",1992,"64","East",10,"Iowa St.","B12",76,7,"Charlotte","CUSA",74,"",3,2,"10 over 7"
"460",460,"20-Mar-92",1992,"64","Midwest",4,"Cincinnati","Amer",85,13,"Delaware","CAA",47,"",-9,38,"4 over 13"
"461",461,"20-Mar-92",1992,"64","West",12,"New Mexico St.","WAC",81,5,"DePaul","BE",73,"",7,8,"12 over 5"
"462",462,"20-Mar-92",1992,"64","Midwest",9,"UTEP","CUSA",55,8,"Evansville","MVC",50,"",1,5,"9 over 8"
"463",463,"20-Mar-92",1992,"64","East",3,"Massachusetts","A10",85,14,"Fordham","A10",58,"",-11,27,"3 over 14"
"464",464,"20-Mar-92",1992,"64","Southeast",2,"Oklahoma St.","B12",100,15,"Georgia Southern","SB",73,"",-13,27,"2 over 15"
"465",465,"20-Mar-92",1992,"64","Midwest",1,"Kansas","B12",100,16,"Howard","MEAC",67,"",-15,33,"1 over 16"
"466",466,"20-Mar-92",1992,"64","Midwest",5,"Michigan St.","B10",61,12,"Missouri St.","MVC",54,"",-7,7,"5 over 12"
"467",467,"20-Mar-92",1992,"64","West",13,"Louisiana Lafayette","SB",87,4,"Oklahoma","B12",83,"",9,4,"13 over 4"
"468",468,"20-Mar-92",1992,"64","East",2,"Kentucky","SEC",88,15,"Old Dominion","CUSA",69,"",-13,19,"2 over 15"
"469",469,"20-Mar-92",1992,"64","East",6,"Syracuse","ACC",51,11,"Princeton","Ivy",43,"",-5,8,"6 over 11"
"470",470,"20-Mar-92",1992,"64","West",1,"UCLA","P12",73,16,"Robert Morris","NEC",53,"",-15,20,"1 over 16"
"471",471,"20-Mar-92",1992,"64","Southeast",10,"Tulane","Amer",61,7,"St. John's","BE",57,"",3,4,"10 over 7"
"472",472,"20-Mar-92",1992,"64","Southeast",6,"Michigan","B10",73,11,"Temple","Amer",66,"",-5,7,"6 over 11"
"473",473,"20-Mar-92",1992,"64","West",8,"Louisville","ACC",81,9,"Wake Forest","ACC",58,"",-1,23,"8 over 9"
"474",474,"21-Mar-92",1992,"32","Southeast",4,"North Carolina","ACC",64,5,"Alabama","SEC",55,"",-1,9,"4 over 5"
"475",475,"21-Mar-92",1992,"32","Midwest",6,"Memphis","Amer",82,3,"Arkansas","SEC",80,"",3,2,"6 over 3"
"476",476,"21-Mar-92",1992,"32","Southeast",1,"Ohio St.","B10",78,9,"Connecticut","Amer",55,"",-8,23,"1 over 9"
"477",477,"21-Mar-92",1992,"32","West",3,"Florida St.","ACC",78,6,"Georgetown","BE",68,"",-3,10,"3 over 6"
"478",478,"21-Mar-92",1992,"32","East",1,"Duke","ACC",75,9,"Iowa","B10",62,"",-8,13,"1 over 9"
"479",479,"21-Mar-92",1992,"32","West",2,"Indiana","B10",89,7,"LSU","SEC",79,"",-5,10,"2 over 7"
"480",480,"21-Mar-92",1992,"32","East",4,"Seton Hall","BE",88,5,"Missouri","SEC",71,"",-1,17,"4 over 5"
"481",481,"21-Mar-92",1992,"32","Midwest",7,"Georgia Tech","ACC",79,2,"USC","P12",78,"",5,1,"7 over 2"
"482",482,"22-Mar-92",1992,"32","Southeast",6,"Michigan","B10",102,14,"East Tennessee St.","SC",90,"",-8,12,"6 over 14"
"483",483,"22-Mar-92",1992,"32","East",2,"Kentucky","SEC",106,10,"Iowa St.","B12",98,"",-8,8,"2 over 10"
"484",484,"22-Mar-92",1992,"32","Midwest",9,"UTEP","CUSA",66,1,"Kansas","B12",60,"",8,6,"9 over 1"
"485",485,"22-Mar-92",1992,"32","West",12,"New Mexico St.","WAC",81,13,"Louisiana Lafayette","SB",73,"",-1,8,"12 over 13"
"486",486,"22-Mar-92",1992,"32","West",1,"UCLA","P12",85,8,"Louisville","ACC",69,"",-7,16,"1 over 8"
"487",487,"22-Mar-92",1992,"32","Midwest",4,"Cincinnati","Amer",77,5,"Michigan St.","B10",65,"",-1,12,"4 over 5"
"488",488,"22-Mar-92",1992,"32","East",3,"Massachusetts","A10",77,6,"Syracuse","ACC",71,"1 OT",-3,6,"3 over 6"
"489",489,"22-Mar-92",1992,"32","Southeast",2,"Oklahoma St.","B12",87,10,"Tulane","Amer",71,"",-8,16,"2 over 10"
"490",490,"26-Mar-92",1992,"16","West",2,"Indiana","B10",85,3,"Florida St.","ACC",74,"",-1,11,"2 over 3"
"491",491,"26-Mar-92",1992,"16","East",2,"Kentucky","SEC",87,3,"Massachusetts","A10",77,"",-1,10,"2 over 3"
"492",492,"26-Mar-92",1992,"16","West",1,"UCLA","P12",85,12,"New Mexico St.","WAC",78,"",-11,7,"1 over 12"
"493",493,"26-Mar-92",1992,"16","East",1,"Duke","ACC",81,4,"Seton Hall","BE",69,"",-3,12,"1 over 4"
"494",494,"27-Mar-92",1992,"16","Midwest",6,"Memphis","Amer",83,7,"Georgia Tech","ACC",79,"1 OT",-1,4,"6 over 7"
"495",495,"27-Mar-92",1992,"16","Southeast",1,"Ohio St.","B10",80,4,"North Carolina","ACC",73,"",-3,7,"1 over 4"
"496",496,"27-Mar-92",1992,"16","Southeast",6,"Michigan","B10",75,2,"Oklahoma St.","B12",72,"",4,3,"6 over 2"
"497",497,"27-Mar-92",1992,"16","Midwest",4,"Cincinnati","Amer",69,9,"UTEP","CUSA",67,"",-5,2,"4 over 9"
"498",498,"28-Mar-92",1992,"8","East",1,"Duke","ACC",104,2,"Kentucky","SEC",103,"1 OT",-1,1,"1 over 2"
"499",499,"28-Mar-92",1992,"8","West",2,"Indiana","B10",106,1,"UCLA","P12",79,"",1,27,"2 over 1"
"500",500,"29-Mar-92",1992,"8","Midwest",4,"Cincinnati","Amer",88,6,"Memphis","Amer",57,"",-2,31,"4 over 6"
"501",501,"29-Mar-92",1992,"8","Southeast",6,"Michigan","B10",75,1,"Ohio St.","B10",71,"1 OT",5,4,"6 over 1"
"502",502,"4-Apr-92",1992,"4","Final Four",6,"Michigan","B10",76,4,"Cincinnati","Amer",72,"",2,4,"6 over 4"
"503",503,"4-Apr-92",1992,"4","Final Four",1,"Duke","ACC",81,2,"Indiana","B10",78,"",-1,3,"1 over 2"
"504",504,"6-Apr-92",1992,"Champ","Championship",1,"Duke","ACC",71,6,"Michigan","B10",51,"",-5,20,"1 over 6"
"505",505,"18-Mar-93",1993,"64","West",15,"Santa Clara","WCC",64,2,"Arizona","P12",61,"",13,3,"15 over 2"
"506",506,"18-Mar-93",1993,"64","Midwest",2,"Kansas","B12",94,15,"Ball St.","MAC",72,"",-13,22,"2 over 15"
"507",507,"18-Mar-93",1993,"64","West",3,"Vanderbilt","SEC",92,14,"Boise St.","MWC",72,"",-11,20,"3 over 14"
"508",508,"18-Mar-93",1993,"64","East",1,"North Carolina","ACC",85,16,"East Carolina","Amer",65,"",-15,20,"1 over 16"
"509",509,"18-Mar-93",1993,"64","Southeast",3,"Florida St.","ACC",82,14,"Evansville","MVC",70,"",-11,12,"3 over 14"
"510",510,"18-Mar-93",1993,"64","East",4,"Arkansas","SEC",94,13,"Holy Cross","Pat",64,"",-9,30,"4 over 13"
"511",511,"18-Mar-93",1993,"64","Southeast",11,"Tulane","Amer",55,6,"Kansas St.","B12",53,"",5,2,"11 over 6"
"512",512,"18-Mar-93",1993,"64","West",6,"Illinois","B10",75,11,"Long Beach St.","BW",72,"",-5,3,"6 over 11"
"513",513,"18-Mar-93",1993,"64","Midwest",6,"California","P12",66,11,"LSU","SEC",64,"",-5,2,"6 over 11"
"514",514,"18-Mar-93",1993,"64","Southeast",7,"Western Kentucky","CUSA",55,10,"Memphis","Amer",52,"",-3,3,"7 over 10"
"515",515,"18-Mar-93",1993,"64","West",7,"Temple","Amer",75,10,"Missouri","SEC",61,"",-3,14,"7 over 10"
"516",516,"18-Mar-93",1993,"64","East",8,"Rhode Island","A10",74,9,"Purdue","B10",68,"",-1,6,"8 over 9"
"517",517,"18-Mar-93",1993,"64","Midwest",7,"BYU","WCC",80,10,"SMU","Amer",71,"",-3,9,"7 over 10"
"518",518,"18-Mar-93",1993,"64","Midwest",3,"Duke","ACC",105,14,"Southern Illinois","MVC",70,"",-11,35,"3 over 14"
"519",519,"18-Mar-93",1993,"64","Southeast",2,"Seton Hall","BE",81,15,"Tennessee St.","OVC",59,"",-13,22,"2 over 15"
"520",520,"18-Mar-93",1993,"64","East",5,"St. John's","BE",85,12,"Texas Tech","B12",67,"",-7,18,"5 over 12"
"521",521,"19-Mar-93",1993,"64","Southeast",5,"Wake Forest","ACC",81,12,"Chattanooga","SC",58,"",-7,23,"5 over 12"
"522",522,"19-Mar-93",1993,"64","West",1,"Michigan","B10",84,16,"Coastal Carolina","SB",53,"",-15,31,"1 over 16"
"523",523,"19-Mar-93",1993,"64","East",2,"Cincinnati","Amer",93,15,"Coppin St.","MEAC",66,"",-13,27,"2 over 15"
"524",524,"19-Mar-93",1993,"64","Midwest",4,"Louisville","ACC",76,13,"Delaware","CAA",70,"",-9,6,"4 over 13"
"525",525,"19-Mar-93",1993,"64","West",13,"Southern","SWAC",93,4,"Georgia Tech","ACC",78,"",9,15,"13 over 4"
"526",526,"19-Mar-93",1993,"64","West",9,"UCLA","P12",81,8,"Iowa St.","B12",70,"",1,11,"9 over 8"
"527",527,"19-Mar-93",1993,"64","Southeast",4,"Iowa","B10",82,13,"Louisiana Monroe","SB",69,"",-9,13,"4 over 13"
"528",528,"19-Mar-93",1993,"64","East",6,"Virginia","ACC",78,11,"Manhattan","MAAC",66,"",-5,12,"6 over 11"
"529",529,"19-Mar-93",1993,"64","Midwest",5,"Oklahoma St.","B12",74,12,"Marquette","BE",62,"",-7,12,"5 over 12"
"530",530,"19-Mar-93",1993,"64","East",7,"New Mexico St.","WAC",93,10,"Nebraska","B10",79,"",-3,14,"7 over 10"
"531",531,"19-Mar-93",1993,"64","West",12,"George Washington","A10",82,5,"New Mexico","MWC",68,"",7,14,"12 over 5"
"532",532,"19-Mar-93",1993,"64","Midwest",9,"Xavier","BE",73,8,"New Orleans","Slnd",55,"",1,18,"9 over 8"
"533",533,"19-Mar-93",1993,"64","East",3,"Massachusetts","A10",54,14,"Penn","Ivy",50,"",-11,4,"3 over 14"
"534",534,"19-Mar-93",1993,"64","Southeast",8,"Utah","P12",86,9,"Pittsburgh","ACC",85,"",-1,1,"8 over 9"
"535",535,"19-Mar-93",1993,"64","Southeast",1,"Kentucky","SEC",96,16,"Rider","MAAC",52,"",-15,44,"1 over 16"
"536",536,"19-Mar-93",1993,"64","Midwest",1,"Indiana","B10",97,16,"Wright St.","Horz",54,"",-15,43,"1 over 16"
"537",537,"20-Mar-93",1993,"32","Midwest",2,"Kansas","B12",90,7,"BYU","WCC",76,"",-5,14,"2 over 7"
"538",538,"20-Mar-93",1993,"32","Midwest",6,"California","P12",82,3,"Duke","ACC",77,"",3,5,"6 over 3"
"539",539,"20-Mar-93",1993,"32","West",3,"Vanderbilt","SEC",85,6,"Illinois","B10",68,"",-3,17,"3 over 6"
"540",540,"20-Mar-93",1993,"32","East",1,"North Carolina","ACC",112,8,"Rhode Island","A10",67,"",-7,45,"1 over 8"
"541",541,"20-Mar-93",1993,"32","West",7,"Temple","Amer",68,15,"Santa Clara","WCC",57,"",-8,11,"7 over 15"
"542",542,"20-Mar-93",1993,"32","Southeast",7,"Western Kentucky","CUSA",72,2,"Seton Hall","BE",68,"",5,4,"7 over 2"
"543",543,"20-Mar-93",1993,"32","East",4,"Arkansas","SEC",80,5,"St. John's","BE",74,"",-1,6,"4 over 5"
"544",544,"20-Mar-93",1993,"32","Southeast",3,"Florida St.","ACC",94,11,"Tulane","Amer",63,"",-8,31,"3 over 11"
"545",545,"21-Mar-93",1993,"32","Southeast",5,"Wake Forest","ACC",84,4,"Iowa","B10",78,"",1,6,"5 over 4"
"546",546,"21-Mar-93",1993,"32","East",6,"Virginia","ACC",71,3,"Massachusetts","A10",56,"",3,15,"6 over 3"
"547",547,"21-Mar-93",1993,"32","East",2,"Cincinnati","Amer",92,7,"New Mexico St.","WAC",55,"",-5,37,"2 over 7"
"548",548,"21-Mar-93",1993,"32","Midwest",4,"Louisville","ACC",78,5,"Oklahoma St.","B12",63,"",-1,15,"4 over 5"
"549",549,"21-Mar-93",1993,"32","West",12,"George Washington","A10",90,13,"Southern","SWAC",80,"",-1,10,"12 over 13"
"550",550,"21-Mar-93",1993,"32","West",1,"Michigan","B10",86,9,"UCLA","P12",84,"1 OT",-8,2,"1 over 9"
"551",551,"21-Mar-93",1993,"32","Southeast",1,"Kentucky","SEC",83,8,"Utah","P12",62,"",-7,21,"1 over 8"
"552",552,"21-Mar-93",1993,"32","Midwest",1,"Indiana","B10",73,9,"Xavier","BE",70,"",-8,3,"1 over 9"
"553",553,"25-Mar-93",1993,"16","Midwest",2,"Kansas","B12",93,6,"California","P12",76,"",-4,17,"2 over 6"
"554",554,"25-Mar-93",1993,"16","Midwest",1,"Indiana","B10",82,4,"Louisville","ACC",69,"",-3,13,"1 over 4"
"555",555,"25-Mar-93",1993,"16","Southeast",1,"Kentucky","SEC",103,5,"Wake Forest","ACC",69,"",-4,34,"1 over 5"
"556",556,"25-Mar-93",1993,"16","Southeast",3,"Florida St.","ACC",81,7,"Western Kentucky","CUSA",78,"1 OT",-4,3,"3 over 7"
"557",557,"26-Mar-93",1993,"16","East",1,"North Carolina","ACC",80,4,"Arkansas","SEC",74,"",-3,6,"1 over 4"
"558",558,"26-Mar-93",1993,"16","West",1,"Michigan","B10",72,12,"George Washington","A10",64,"",-11,8,"1 over 12"
"559",559,"26-Mar-93",1993,"16","West",7,"Temple","Amer",67,3,"Vanderbilt","SEC",59,"",4,8,"7 over 3"
"560",560,"26-Mar-93",1993,"16","East",2,"Cincinnati","Amer",71,6,"Virginia","ACC",54,"",-4,17,"2 over 6"
"561",561,"27-Mar-93",1993,"8","Southeast",1,"Kentucky","SEC",106,3,"Florida St.","ACC",81,"",-2,25,"1 over 3"
"562",562,"27-Mar-93",1993,"8","Midwest",2,"Kansas","B12",83,1,"Indiana","B10",77,"",1,6,"2 over 1"
"563",563,"28-Mar-93",1993,"8","East",1,"North Carolina","ACC",75,2,"Cincinnati","Amer",68,"1 OT",-1,7,"1 over 2"
"564",564,"28-Mar-93",1993,"8","West",1,"Michigan","B10",77,7,"Temple","Amer",72,"",-6,5,"1 over 7"
"565",565,"3-Apr-93",1993,"4","Final Four",1,"North Carolina","ACC",78,2,"Kansas","B12",68,"",-1,10,"1 over 2"
"566",566,"3-Apr-93",1993,"4","Final Four",1,"Michigan","B10",81,1,"Kentucky","SEC",78,"1 OT",0,3,"1 over 1"
"567",567,"5-Apr-93",1993,"Champ","Championship",1,"North Carolina","ACC",77,1,"Michigan","B10",71,"",0,6,"1 over 1"
"568",568,"17-Mar-94",1994,"64","West",12,"Green Bay","Horz",61,5,"California","P12",57,"",7,4,"12 over 5"
"569",569,"17-Mar-94",1994,"64","Southeast",5,"Wake Forest","ACC",68,12,"Charleston Southern","BSth",58,"",-7,10,"5 over 12"
"570",570,"17-Mar-94",1994,"64","Southeast",4,"Kansas","B12",102,13,"Chattanooga","SC",73,"",-9,29,"4 over 13"
"571",571,"17-Mar-94",1994,"64","West",9,"Wisconsin","B10",80,8,"Cincinnati","Amer",72,"",1,8,"9 over 8"
"572",572,"17-Mar-94",1994,"64","West",4,"Syracuse","ACC",92,13,"Hawaii","BW",78,"",-9,14,"4 over 13"
"573",573,"17-Mar-94",1994,"64","East",3,"Florida","SEC",64,14,"James Madison","CAA",62,"",-11,2,"3 over 14"
"574",574,"17-Mar-94",1994,"64","West",1,"Missouri","SEC",76,16,"Navy","Pat",53,"",-15,23,"1 over 16"
"575",575,"17-Mar-94",1994,"64","East",11,"Penn","Ivy",90,6,"Nebraska","B10",80,"",5,10,"11 over 6"
"576",576,"17-Mar-94",1994,"64","Midwest",3,"Michigan","B10",78,14,"Pepperdine","WCC",74,"1 OT",-11,4,"3 over 14"
"577",577,"17-Mar-94",1994,"64","Southeast",9,"Alabama","SEC",76,8,"Providence","BE",70,"",1,6,"9 over 8"
"578",578,"17-Mar-94",1994,"64","East",2,"Connecticut","Amer",64,15,"Rider","MAAC",46,"",-13,18,"2 over 15"
"579",579,"17-Mar-94",1994,"64","Midwest",10,"Maryland","B10",74,7,"Saint Louis","A10",66,"",3,8,"10 over 7"
"580",580,"17-Mar-94",1994,"64","Midwest",2,"Massachusetts","A10",78,15,"Texas St.","SB",60,"",-13,18,"2 over 15"
"581",581,"17-Mar-94",1994,"64","East",10,"George Washington","A10",51,7,"UAB","CUSA",46,"",3,5,"10 over 7"
"582",582,"17-Mar-94",1994,"64","Southeast",1,"Purdue","B10",98,16,"UCF","Amer",67,"",-15,31,"1 over 16"
"583",583,"17-Mar-94",1994,"64","Midwest",6,"Texas","B12",91,11,"Western Kentucky","CUSA",77,"",-5,14,"6 over 11"
"584",584,"18-Mar-94",1994,"64","West",3,"Louisville","ACC",67,14,"Boise St.","MWC",58,"",-11,9,"3 over 14"
"585",585,"18-Mar-94",1994,"64","East",4,"Temple","Amer",61,13,"Drexel","CAA",39,"",-9,22,"4 over 13"
"586",586,"18-Mar-94",1994,"64","Midwest",9,"Georgetown","BE",84,8,"Illinois","B10",77,"",1,7,"9 over 8"
"587",587,"18-Mar-94",1994,"64","East",1,"North Carolina","ACC",71,16,"Liberty","BSth",51,"",-15,20,"1 over 16"
"588",588,"18-Mar-94",1994,"64","Southeast",6,"Marquette","BE",81,11,"Louisiana Lafayette","SB",59,"",-5,22,"6 over 11"
"589",589,"18-Mar-94",1994,"64","West",2,"Arizona","P12",81,15,"Loyola, Maryland",NA,55,"",-13,26,"2 over 15"
"590",590,"18-Mar-94",1994,"64","West",7,"Virginia","ACC",57,10,"New Mexico","MWC",54,"",-3,3,"7 over 10"
"591",591,"18-Mar-94",1994,"64","Midwest",4,"Oklahoma St.","B12",65,13,"New Mexico St.","WAC",55,"",-9,10,"4 over 13"
"592",592,"18-Mar-94",1994,"64","Midwest",1,"Arkansas","SEC",94,16,"North Carolina A&T","MEAC",79,"",-15,15,"1 over 16"
"593",593,"18-Mar-94",1994,"64","East",5,"Indiana","B10",84,12,"Ohio","MAC",72,"",-7,12,"5 over 12"
"594",594,"18-Mar-94",1994,"64","Southeast",7,"Michigan St.","B10",84,10,"Seton Hall","BE",73,"",-3,11,"7 over 10"
"595",595,"18-Mar-94",1994,"64","West",6,"Minnesota","B10",74,11,"Southern Illinois","MVC",60,"",-5,14,"6 over 11"
"596",596,"18-Mar-94",1994,"64","Southeast",3,"Kentucky","SEC",83,14,"Tennessee St.","OVC",70,"",-11,13,"3 over 14"
"597",597,"18-Mar-94",1994,"64","Southeast",2,"Duke","ACC",82,15,"Texas Southern","SWAC",70,"",-13,12,"2 over 15"
"598",598,"18-Mar-94",1994,"64","Midwest",12,"Tulsa","Amer",112,5,"UCLA","P12",102,"",7,10,"12 over 5"
"599",599,"18-Mar-94",1994,"64","East",9,"Boston College","ACC",67,8,"Washington St.","P12",64,"",1,3,"9 over 8"
"600",600,"19-Mar-94",1994,"32","Southeast",1,"Purdue","B10",83,9,"Alabama","SEC",73,"",-8,10,"1 over 9"
"601",601,"19-Mar-94",1994,"32","East",2,"Connecticut","Amer",75,10,"George Washington","A10",63,"",-8,12,"2 over 10"
"602",602,"19-Mar-94",1994,"32","West",4,"Syracuse","ACC",64,12,"Green Bay","Horz",59,"",-8,5,"4 over 12"
"603",603,"19-Mar-94",1994,"32","Midwest",10,"Maryland","B10",95,2,"Massachusetts","A10",87,"",8,8,"10 over 2"
"604",604,"19-Mar-94",1994,"32","East",3,"Florida","SEC",70,11,"Penn","Ivy",58,"",-8,12,"3 over 11"
"605",605,"19-Mar-94",1994,"32","Midwest",3,"Michigan","B10",84,6,"Texas","B12",79,"",-3,5,"3 over 6"
"606",606,"19-Mar-94",1994,"32","Southeast",4,"Kansas","B12",69,5,"Wake Forest","ACC",58,"",-1,11,"4 over 5"
"607",607,"19-Mar-94",1994,"32","West",1,"Missouri","SEC",109,9,"Wisconsin","B10",96,"",-8,13,"1 over 9"
"608",608,"20-Mar-94",1994,"32","Midwest",1,"Arkansas","SEC",85,9,"Georgetown","BE",73,"",-8,12,"1 over 9"
"609",609,"20-Mar-94",1994,"32","Southeast",6,"Marquette","BE",75,3,"Kentucky","SEC",63,"",3,12,"6 over 3"
"610",610,"20-Mar-94",1994,"32","Southeast",2,"Duke","ACC",85,7,"Michigan St.","B10",74,"",-5,11,"2 over 7"
"611",611,"20-Mar-94",1994,"32","West",3,"Louisville","ACC",60,6,"Minnesota","B10",55,"",-3,5,"3 over 6"
"612",612,"20-Mar-94",1994,"32","East",9,"Boston College","ACC",75,1,"North Carolina","ACC",72,"",8,3,"9 over 1"
"613",613,"20-Mar-94",1994,"32","Midwest",12,"Tulsa","Amer",82,4,"Oklahoma St.","B12",80,"",8,2,"12 over 4"
"614",614,"20-Mar-94",1994,"32","East",5,"Indiana","B10",67,4,"Temple","Amer",58,"",1,9,"5 over 4"
"615",615,"20-Mar-94",1994,"32","West",2,"Arizona","P12",71,7,"Virginia","ACC",58,"",-5,13,"2 over 7"
"616",616,"24-Mar-94",1994,"16","Southeast",1,"Purdue","B10",83,4,"Kansas","B12",78,"",-3,5,"1 over 4"
"617",617,"24-Mar-94",1994,"16","West",2,"Arizona","P12",82,3,"Louisville","ACC",70,"",-1,12,"2 over 3"
"618",618,"24-Mar-94",1994,"16","Southeast",2,"Duke","ACC",59,6,"Marquette","BE",49,"",-4,10,"2 over 6"
"619",619,"24-Mar-94",1994,"16","West",1,"Missouri","SEC",98,4,"Syracuse","ACC",88,"1 OT",-3,10,"1 over 4"
"620",620,"25-Mar-94",1994,"16","East",3,"Florida","SEC",69,2,"Connecticut","Amer",60,"1 OT",1,9,"3 over 2"
"621",621,"25-Mar-94",1994,"16","East",9,"Boston College","ACC",77,5,"Indiana","B10",68,"",4,9,"9 over 5"
"622",622,"25-Mar-94",1994,"16","Midwest",3,"Michigan","B10",78,10,"Maryland","B10",71,"",-7,7,"3 over 10"
"623",623,"25-Mar-94",1994,"16","Midwest",1,"Arkansas","SEC",103,12,"Tulsa","Amer",84,"",-11,19,"1 over 12"
"624",624,"26-Mar-94",1994,"8","West",2,"Arizona","P12",92,1,"Missouri","SEC",72,"",1,20,"2 over 1"
"625",625,"26-Mar-94",1994,"8","Southeast",2,"Duke","ACC",69,1,"Purdue","B10",60,"",1,9,"2 over 1"
"626",626,"27-Mar-94",1994,"8","East",3,"Florida","SEC",74,9,"Boston College","ACC",66,"",-6,8,"3 over 9"
"627",627,"27-Mar-94",1994,"8","Midwest",1,"Arkansas","SEC",76,3,"Michigan","B10",68,"",-2,8,"1 over 3"
"628",628,"2-Apr-94",1994,"4","Final Four",1,"Arkansas","SEC",91,2,"Arizona","P12",82,"",-1,9,"1 over 2"
"629",629,"2-Apr-94",1994,"4","Final Four",2,"Duke","ACC",70,3,"Florida","SEC",65,"",-1,5,"2 over 3"
"630",630,"4-Apr-94",1994,"Champ","Championship",1,"Arkansas","SEC",76,2,"Duke","ACC",72,"",-1,4,"1 over 2"
"631",631,"16-Mar-95",1995,"64","Midwest",12,"Miami OH","MAC",71,5,"Arizona","P12",62,"",7,9,"12 over 5"
"632",632,"16-Mar-95",1995,"64","Southeast",5,"Arizona St.","P12",81,12,"Ball St.","MAC",66,"",-7,15,"5 over 12"
"633",633,"16-Mar-95",1995,"64","Southeast",9,"Tulane","Amer",76,8,"BYU","WCC",70,"",1,6,"9 over 8"
"634",634,"16-Mar-95",1995,"64","West",2,"Connecticut","Amer",100,15,"Chattanooga","SC",71,"",-13,29,"2 over 15"
"635",635,"16-Mar-95",1995,"64","Midwest",1,"Kansas","B12",82,16,"Colgate","Pat",68,"",-15,14,"1 over 16"
"636",636,"16-Mar-95",1995,"64","East",4,"Oklahoma St.","B12",73,13,"Drexel","CAA",49,"",-9,24,"4 over 13"
"637",637,"16-Mar-95",1995,"64","West",3,"Maryland","B10",87,14,"Gonzaga","WCC",63,"",-11,24,"3 over 14"
"638",638,"16-Mar-95",1995,"64","Midwest",8,"Western Kentucky","CUSA",82,9,"Michigan","B10",76,"1 OT",-1,6,"8 over 9"
"639",639,"16-Mar-95",1995,"64","East",9,"Saint Louis","A10",64,8,"Minnesota","B10",61,"1 OT",1,3,"9 over 8"
"640",640,"16-Mar-95",1995,"64","Southeast",1,"Kentucky","SEC",113,16,"Mount St. Mary's","NEC",67,"",-15,46,"1 over 16"
"641",641,"16-Mar-95",1995,"64","Midwest",4,"Virginia","ACC",96,13,"Nicholls St.","Slnd",72,"",-9,24,"4 over 13"
"642",642,"16-Mar-95",1995,"64","East",1,"Wake Forest","ACC",79,16,"North Carolina A&T","MEAC",47,"",-15,32,"1 over 16"
"643",643,"16-Mar-95",1995,"64","Southeast",13,"Manhattan","MAAC",77,4,"Oklahoma","B12",67,"",9,10,"13 over 4"
"644",644,"16-Mar-95",1995,"64","West",11,"Texas","B12",90,6,"Oregon","P12",73,"",5,17,"11 over 6"
"645",645,"16-Mar-95",1995,"64","East",5,"Alabama","SEC",91,12,"Penn","Ivy",85,"1 OT",-7,6,"5 over 12"
"646",646,"16-Mar-95",1995,"64","West",7,"Cincinnati","Amer",77,10,"Temple","Amer",71,"",-3,6,"7 over 10"
"647",647,"17-Mar-95",1995,"64","East",10,"Stanford","P12",70,7,"Charlotte","CUSA",68,"",3,2,"10 over 7"
"648",648,"17-Mar-95",1995,"64","Southeast",7,"Iowa St.","B12",64,10,"Florida","SEC",61,"",-3,3,"7 over 10"
"649",649,"17-Mar-95",1995,"64","West",1,"UCLA","P12",92,16,"Florida International",NA,56,"",-15,36,"1 over 16"
"650",650,"17-Mar-95",1995,"64","Midwest",3,"Purdue","B10",49,14,"Green Bay","Horz",48,"",-11,1,"3 over 14"
"651",651,"17-Mar-95",1995,"64","East",6,"Tulsa","Amer",68,11,"Illinois","B10",62,"",-5,6,"6 over 11"
"652",652,"17-Mar-95",1995,"64","West",8,"Missouri","SEC",65,9,"Indiana","B10",60,"",-1,5,"8 over 9"
"653",653,"17-Mar-95",1995,"64","West",4,"Utah","P12",76,13,"Long Beach St.","BW",64,"",-9,12,"4 over 13"
"654",654,"17-Mar-95",1995,"64","Midwest",6,"Memphis","Amer",77,11,"Louisville","ACC",56,"",-5,21,"6 over 11"
"655",655,"17-Mar-95",1995,"64","Southeast",14,"Weber St.","BSky",79,3,"Michigan St.","B10",72,"",11,7,"14 over 3"
"656",656,"17-Mar-95",1995,"64","Southeast",2,"North Carolina","ACC",80,15,"Murray St.","OVC",70,"",-13,10,"2 over 15"
"657",657,"17-Mar-95",1995,"64","West",5,"Mississippi St.","SEC",75,12,"Santa Clara","WCC",67,"",-7,8,"5 over 12"
"658",658,"17-Mar-95",1995,"64","Midwest",7,"Syracuse","ACC",96,10,"Southern Illinois","MVC",92,"",-3,4,"7 over 10"
"659",659,"17-Mar-95",1995,"64","East",2,"Massachusetts","A10",68,15,"St. Peter's",NA,51,"",-13,17,"2 over 15"
"660",660,"17-Mar-95",1995,"64","Midwest",2,"Arkansas","SEC",79,15,"Texas Southern","SWAC",78,"",-13,1,"2 over 15"
"661",661,"17-Mar-95",1995,"64","East",14,"Old Dominion","CUSA",89,3,"Villanova","BE",81,"3 OT",11,8,"14 over 3"
"662",662,"17-Mar-95",1995,"64","Southeast",6,"Georgetown","BE",68,11,"Xavier","BE",63,"",-5,5,"6 over 11"
"663",663,"18-Mar-95",1995,"32","East",4,"Oklahoma St.","B12",66,5,"Alabama","SEC",52,"",-1,14,"4 over 5"
"664",664,"18-Mar-95",1995,"32","West",2,"Connecticut","Amer",96,7,"Cincinnati","Amer",91,"",-5,5,"2 over 7"
"665",665,"18-Mar-95",1995,"32","Southeast",5,"Arizona St.","P12",64,13,"Manhattan","MAAC",54,"",-8,10,"5 over 13"
"666",666,"18-Mar-95",1995,"32","Midwest",4,"Virginia","ACC",60,12,"Miami OH","MAC",54,"1 OT",-8,6,"4 over 12"
"667",667,"18-Mar-95",1995,"32","East",1,"Wake Forest","ACC",64,9,"Saint Louis","A10",59,"",-8,5,"1 over 9"
"668",668,"18-Mar-95",1995,"32","West",3,"Maryland","B10",82,11,"Texas","B12",68,"",-8,14,"3 over 11"
"669",669,"18-Mar-95",1995,"32","Southeast",1,"Kentucky","SEC",82,9,"Tulane","Amer",60,"",-8,22,"1 over 9"
"670",670,"18-Mar-95",1995,"32","Midwest",1,"Kansas","B12",75,8,"Western Kentucky","CUSA",70,"",-7,5,"1 over 8"
"671",671,"19-Mar-95",1995,"32","Southeast",2,"North Carolina","ACC",73,7,"Iowa St.","B12",51,"",-5,22,"2 over 7"
"672",672,"19-Mar-95",1995,"32","West",1,"UCLA","P12",75,8,"Missouri","SEC",74,"",-7,1,"1 over 8"
"673",673,"19-Mar-95",1995,"32","East",6,"Tulsa","Amer",64,14,"Old Dominion","CUSA",52,"",-8,12,"6 over 14"
"674",674,"19-Mar-95",1995,"32","Midwest",6,"Memphis","Amer",75,3,"Purdue","B10",73,"",3,2,"6 over 3"
"675",675,"19-Mar-95",1995,"32","East",2,"Massachusetts","A10",75,10,"Stanford","P12",53,"",-8,22,"2 over 10"
"676",676,"19-Mar-95",1995,"32","Midwest",2,"Arkansas","SEC",96,7,"Syracuse","ACC",94,"1 OT",-5,2,"2 over 7"
"677",677,"19-Mar-95",1995,"32","West",5,"Mississippi St.","SEC",78,4,"Utah","P12",64,"",1,14,"5 over 4"
"678",678,"19-Mar-95",1995,"32","Southeast",6,"Georgetown","BE",53,14,"Weber St.","BSky",51,"",-8,2,"6 over 14"
"679",679,"23-Mar-95",1995,"16","Southeast",1,"Kentucky","SEC",97,5,"Arizona St.","P12",73,"",-4,24,"1 over 5"
"680",680,"23-Mar-95",1995,"16","Southeast",2,"North Carolina","ACC",74,6,"Georgetown","BE",64,"",-4,10,"2 over 6"
"681",681,"23-Mar-95",1995,"16","West",2,"Connecticut","Amer",99,3,"Maryland","B10",89,"",-1,10,"2 over 3"
"682",682,"23-Mar-95",1995,"16","West",1,"UCLA","P12",86,5,"Mississippi St.","SEC",67,"",-4,19,"1 over 5"
"683",683,"24-Mar-95",1995,"16","Midwest",4,"Virginia","ACC",67,1,"Kansas","B12",58,"",3,9,"4 over 1"
"684",684,"24-Mar-95",1995,"16","Midwest",2,"Arkansas","SEC",96,6,"Memphis","Amer",91,"1 OT",-4,5,"2 over 6"
"685",685,"24-Mar-95",1995,"16","East",2,"Massachusetts","A10",76,6,"Tulsa","Amer",51,"",-4,25,"2 over 6"
"686",686,"24-Mar-95",1995,"16","East",4,"Oklahoma St.","B12",71,1,"Wake Forest","ACC",66,"",3,5,"4 over 1"
"687",687,"25-Mar-95",1995,"8","West",1,"UCLA","P12",102,2,"Connecticut","Amer",96,"",-1,6,"1 over 2"
"688",688,"25-Mar-95",1995,"8","Southeast",2,"North Carolina","ACC",74,1,"Kentucky","SEC",61,"",1,13,"2 over 1"
"689",689,"26-Mar-95",1995,"8","East",4,"Oklahoma St.","B12",68,2,"Massachusetts","A10",54,"",2,14,"4 over 2"
"690",690,"26-Mar-95",1995,"8","Midwest",2,"Arkansas","SEC",68,4,"Virginia","ACC",61,"",-2,7,"2 over 4"
"691",691,"1-Apr-95",1995,"4","Final Four",2,"Arkansas","SEC",75,2,"North Carolina","ACC",68,"",0,7,"2 over 2"
"692",692,"1-Apr-95",1995,"4","Final Four",1,"UCLA","P12",74,4,"Oklahoma St.","B12",61,"",-3,13,"1 over 4"
"693",693,"3-Apr-95",1995,"Champ","Championship",1,"UCLA","P12",89,2,"Arkansas","SEC",78,"",-1,11,"1 over 2"
"694",694,"14-Mar-96",1996,"64","East",9,"Stanford","P12",66,8,"Bradley","MVC",58,"",1,8,"9 over 8"
"695",695,"14-Mar-96",1996,"64","Midwest",5,"Iowa St.","B12",74,12,"California","P12",64,"",-7,10,"5 over 12"
"696",696,"14-Mar-96",1996,"64","Midwest",4,"Utah","P12",72,13,"Canisius","MAAC",43,"",-9,29,"4 over 13"
"697",697,"14-Mar-96",1996,"64","West",8,"Georgia","SEC",81,9,"Clemson","ACC",74,"",-1,7,"8 over 9"
"698",698,"14-Mar-96",1996,"64","Southeast",1,"Connecticut","Amer",68,16,"Colgate","Pat",59,"",-15,9,"1 over 16"
"699",699,"14-Mar-96",1996,"64","Southeast",9,"Eastern Michigan","MAC",75,8,"Duke","ACC",60,"",1,15,"9 over 8"
"700",700,"14-Mar-96",1996,"64","Midwest",9,"Virginia Tech","ACC",61,8,"Green Bay","Horz",48,"",1,13,"9 over 8"
"701",701,"14-Mar-96",1996,"64","West",12,"Drexel","CAA",75,5,"Memphis","Amer",63,"",7,12,"12 over 5"
"702",702,"14-Mar-96",1996,"64","East",4,"Marquette","BE",68,13,"Monmouth","MAAC",44,"",-9,24,"4 over 13"
"703",703,"14-Mar-96",1996,"64","West",4,"Syracuse","ACC",88,13,"Montana St.","BSky",55,"",-9,33,"4 over 13"
"704",704,"14-Mar-96",1996,"64","East",12,"Arkansas","SEC",86,5,"Penn St.","B10",80,"",7,6,"12 over 5"
"705",705,"14-Mar-96",1996,"64","Midwest",1,"Kentucky","SEC",110,16,"San Jose St.","MWC",72,"",-15,38,"1 over 16"
"706",706,"14-Mar-96",1996,"64","East",1,"Massachusetts","A10",92,16,"UCF","Amer",70,"",-15,22,"1 over 16"
"707",707,"14-Mar-96",1996,"64","Southeast",13,"Princeton","Ivy",43,4,"UCLA","P12",41,"",9,2,"13 over 4"
"708",708,"14-Mar-96",1996,"64","Southeast",5,"Mississippi St.","SEC",58,12,"VCU","A10",51,"",-7,7,"5 over 12"
"709",709,"14-Mar-96",1996,"64","West",1,"Purdue","B10",73,16,"Western Carolina","SC",71,"",-15,2,"1 over 16"
"710",710,"15-Mar-96",1996,"64","Southeast",3,"Georgia Tech","ACC",90,14,"Austin Peay","OVC",79,"",-11,11,"3 over 14"
"711",711,"15-Mar-96",1996,"64","West",6,"Iowa","B10",81,11,"George Washington","A10",79,"",-5,2,"6 over 11"
"712",712,"15-Mar-96",1996,"64","Southeast",11,"Boston College","ACC",64,6,"Indiana","B10",51,"",5,13,"11 over 6"
"713",713,"15-Mar-96",1996,"64","East",7,"New Mexico","MWC",69,10,"Kansas St.","B12",48,"",-3,21,"7 over 10"
"714",714,"15-Mar-96",1996,"64","Midwest",2,"Wake Forest","ACC",62,15,"Louisiana Monroe","SB",50,"",-13,12,"2 over 15"
"715",715,"15-Mar-96",1996,"64","West",10,"Santa Clara","WCC",91,7,"Maryland","B10",79,"",3,12,"10 over 7"
"716",716,"15-Mar-96",1996,"64","Midwest",10,"Texas","B12",80,7,"Michigan","B10",76,"",3,4,"10 over 7"
"717",717,"15-Mar-96",1996,"64","East",2,"Georgetown","BE",93,15,"Mississippi Valley",NA,56,"",-13,37,"2 over 15"
"718",718,"15-Mar-96",1996,"64","East",6,"North Carolina","ACC",83,11,"New Orleans","Slnd",62,"",-5,21,"6 over 11"
"719",719,"15-Mar-96",1996,"64","Southeast",2,"Cincinnati","Amer",66,15,"North Carolina Greensboro",NA,61,"",-13,5,"2 over 15"
"720",720,"15-Mar-96",1996,"64","East",3,"Texas Tech","B12",74,14,"Northern Illinois","MAC",73,"",-11,1,"3 over 14"
"721",721,"15-Mar-96",1996,"64","Southeast",7,"Temple","Amer",61,10,"Oklahoma","B12",43,"",-3,18,"7 over 10"
"722",722,"15-Mar-96",1996,"64","Midwest",3,"Villanova","BE",92,14,"Portland","WCC",58,"",-11,34,"3 over 14"
"723",723,"15-Mar-96",1996,"64","West",2,"Kansas","B12",92,15,"South Carolina St.","MEAC",54,"",-13,38,"2 over 15"
"724",724,"15-Mar-96",1996,"64","Midwest",6,"Louisville","ACC",82,11,"Tulsa","Amer",80,"1 OT",-5,2,"6 over 11"
"725",725,"15-Mar-96",1996,"64","West",3,"Arizona","P12",90,14,"Valparaiso","Horz",51,"",-11,39,"3 over 14"
"726",726,"16-Mar-96",1996,"32","West",4,"Syracuse","ACC",69,12,"Drexel","CAA",58,"",-8,11,"4 over 12"
"727",727,"16-Mar-96",1996,"32","Southeast",1,"Connecticut","Amer",95,9,"Eastern Michigan","MAC",81,"",-8,14,"1 over 9"
"728",728,"16-Mar-96",1996,"32","Midwest",4,"Utah","P12",73,5,"Iowa St.","B12",67,"",-1,6,"4 over 5"
"729",729,"16-Mar-96",1996,"32","East",12,"Arkansas","SEC",65,4,"Marquette","BE",56,"",8,9,"12 over 4"
"730",730,"16-Mar-96",1996,"32","Southeast",5,"Mississippi St.","SEC",63,13,"Princeton","Ivy",41,"",-8,22,"5 over 13"
"731",731,"16-Mar-96",1996,"32","West",8,"Georgia","SEC",76,1,"Purdue","B10",69,"",7,7,"8 over 1"
"732",732,"16-Mar-96",1996,"32","East",1,"Massachusetts","A10",79,9,"Stanford","P12",74,"",-8,5,"1 over 9"
"733",733,"16-Mar-96",1996,"32","Midwest",1,"Kentucky","SEC",84,9,"Virginia Tech","ACC",60,"",-8,24,"1 over 9"
"734",734,"17-Mar-96",1996,"32","Southeast",3,"Georgia Tech","ACC",103,11,"Boston College","ACC",89,"",-8,14,"3 over 11"
"735",735,"17-Mar-96",1996,"32","West",3,"Arizona","P12",87,6,"Iowa","B10",73,"",-3,14,"3 over 6"
"736",736,"17-Mar-96",1996,"32","East",2,"Georgetown","BE",73,7,"New Mexico","MWC",62,"",-5,11,"2 over 7"
"737",737,"17-Mar-96",1996,"32","East",3,"Texas Tech","B12",92,6,"North Carolina","ACC",73,"",-3,19,"3 over 6"
"738",738,"17-Mar-96",1996,"32","West",2,"Kansas","B12",76,10,"Santa Clara","WCC",51,"",-8,25,"2 over 10"
"739",739,"17-Mar-96",1996,"32","Southeast",2,"Cincinnati","Amer",78,7,"Temple","Amer",65,"",-5,13,"2 over 7"
"740",740,"17-Mar-96",1996,"32","Midwest",2,"Wake Forest","ACC",65,10,"Texas","B12",62,"",-8,3,"2 over 10"
"741",741,"17-Mar-96",1996,"32","Midwest",6,"Louisville","ACC",68,3,"Villanova","BE",64,"",3,4,"6 over 3"
"742",742,"21-Mar-96",1996,"16","East",1,"Massachusetts","A10",79,12,"Arkansas","SEC",63,"",-11,16,"1 over 12"
"743",743,"21-Mar-96",1996,"16","Midwest",2,"Wake Forest","ACC",60,6,"Louisville","ACC",59,"",-4,1,"2 over 6"
"744",744,"21-Mar-96",1996,"16","East",2,"Georgetown","BE",98,3,"Texas Tech","B12",90,"",-1,8,"2 over 3"
"745",745,"21-Mar-96",1996,"16","Midwest",1,"Kentucky","SEC",101,4,"Utah","P12",70,"",-3,31,"1 over 4"
"746",746,"22-Mar-96",1996,"16","West",2,"Kansas","B12",83,3,"Arizona","P12",80,"",-1,3,"2 over 3"
"747",747,"22-Mar-96",1996,"16","Southeast",5,"Mississippi St.","SEC",60,1,"Connecticut","Amer",55,"",4,5,"5 over 1"
"748",748,"22-Mar-96",1996,"16","West",4,"Syracuse","ACC",83,8,"Georgia","SEC",81,"1 OT",-4,2,"4 over 8"
"749",749,"22-Mar-96",1996,"16","Southeast",2,"Cincinnati","Amer",87,3,"Georgia Tech","ACC",70,"",-1,17,"2 over 3"
"750",750,"23-Mar-96",1996,"8","East",1,"Massachusetts","A10",86,2,"Georgetown","BE",62,"",-1,24,"1 over 2"
"751",751,"23-Mar-96",1996,"8","Midwest",1,"Kentucky","SEC",83,2,"Wake Forest","ACC",63,"",-1,20,"1 over 2"
"752",752,"24-Mar-96",1996,"8","Southeast",5,"Mississippi St.","SEC",73,2,"Cincinnati","Amer",63,"",3,10,"5 over 2"
"753",753,"24-Mar-96",1996,"8","West",4,"Syracuse","ACC",60,2,"Kansas","B12",57,"",2,3,"4 over 2"
"754",754,"30-Mar-96",1996,"4","Final Four",1,"Kentucky","SEC",81,1,"Massachusetts","A10",74,"",0,7,"1 over 1"
"755",755,"30-Mar-96",1996,"4","Final Four",4,"Syracuse","ACC",77,5,"Mississippi St.","SEC",69,"",-1,8,"4 over 5"
"756",756,"1-Apr-96",1996,"Champ","Championship",1,"Kentucky","SEC",76,4,"Syracuse","ACC",67,"",-3,9,"1 over 4"
"757",757,"13-Mar-97",1997,"64","Midwest",3,"Cincinnati","Amer",86,14,"Butler","BE",69,"",-11,17,"3 over 14"
"758",758,"13-Mar-97",1997,"64","Midwest",2,"UCLA","P12",109,15,"Charleston Southern","BSth",75,"",-13,34,"2 over 15"
"759",759,"13-Mar-97",1997,"64","East",1,"North Carolina","ACC",82,16,"Fairfield","MAAC",74,"",-15,8,"1 over 16"
"760",760,"13-Mar-97",1997,"64","Midwest",6,"Iowa St.","B12",69,11,"Illinois St.","MVC",57,"",-5,12,"6 over 11"
"761",761,"13-Mar-97",1997,"64","East",9,"Colorado","P12",80,8,"Indiana","B10",62,"",1,18,"9 over 8"
"762",762,"13-Mar-97",1997,"64","Southeast",1,"Kansas","B12",78,16,"Jackson St.","SWAC",64,"",-15,14,"1 over 16"
"763",763,"13-Mar-97",1997,"64","East",4,"Villanova","BE",101,13,"Long Island Brooklyn",NA,91,"",-9,10,"4 over 13"
"764",764,"13-Mar-97",1997,"64","Southeast",12,"Charleston Southern","BSth",75,5,"Maryland","B10",66,"",7,9,"12 over 5"
"765",765,"13-Mar-97",1997,"64","West",1,"Kentucky","SEC",92,16,"Montana","BSky",54,"",-15,38,"1 over 16"
"766",766,"13-Mar-97",1997,"64","West",4,"Saint Joseph's","A10",75,13,"Pacific","WCC",65,"",-9,10,"4 over 13"
"767",767,"13-Mar-97",1997,"64","East",5,"California","P12",55,12,"Princeton","Ivy",52,"",-7,3,"5 over 12"
"768",768,"13-Mar-97",1997,"64","Southeast",8,"Purdue","B10",83,9,"Rhode Island","A10",76,"1 OT",-1,7,"8 over 9"
"769",769,"13-Mar-97",1997,"64","Southeast",4,"Arizona","P12",65,13,"South Alabama","SB",57,"",-9,8,"4 over 13"
"770",770,"13-Mar-97",1997,"64","West",5,"Boston College","ACC",73,12,"Valparaiso","Horz",66,"",-7,7,"5 over 12"
"771",771,"13-Mar-97",1997,"64","Midwest",7,"Xavier","BE",80,10,"Vanderbilt","SEC",68,"",-3,12,"7 over 10"
"772",772,"13-Mar-97",1997,"64","West",8,"Iowa","B10",73,9,"Virginia","ACC",60,"",-1,13,"8 over 9"
"773",773,"14-Mar-97",1997,"64","Midwest",5,"Tulsa","Amer",81,12,"Boston University","Pat",52,"",-7,29,"5 over 12"
"774",774,"14-Mar-97",1997,"64","West",7,"Charlotte","CUSA",79,10,"Georgetown","BE",67,"",-3,12,"7 over 10"
"775",775,"14-Mar-97",1997,"64","Southeast",14,"Chattanooga","SC",73,3,"Georgia","SEC",70,"",11,3,"14 over 3"
"776",776,"14-Mar-97",1997,"64","Southeast",10,"Providence","BE",81,7,"Marquette","BE",59,"",3,22,"10 over 7"
"777",777,"14-Mar-97",1997,"64","East",6,"Louisville","ACC",65,11,"Massachusetts","A10",57,"",-5,8,"6 over 11"
"778",778,"14-Mar-97",1997,"64","Midwest",4,"Clemson","ACC",68,13,"Miami OH","MAC",56,"",-9,12,"4 over 13"
"779",779,"14-Mar-97",1997,"64","Midwest",9,"Temple","Amer",62,8,"Mississippi","SEC",40,"",1,22,"9 over 8"
"780",780,"14-Mar-97",1997,"64","Southeast",2,"Duke","ACC",81,15,"Murray St.","OVC",78,"",-13,3,"2 over 15"
"781",781,"14-Mar-97",1997,"64","West",2,"Utah","P12",75,15,"Navy","Pat",61,"",-13,14,"2 over 15"
"782",782,"14-Mar-97",1997,"64","West",6,"Stanford","P12",80,11,"Oklahoma","B12",67,"",-5,13,"6 over 11"
"783",783,"14-Mar-97",1997,"64","East",3,"New Mexico","MWC",59,14,"Old Dominion","CUSA",55,"",-11,4,"3 over 14"
"784",784,"14-Mar-97",1997,"64","West",3,"Wake Forest","ACC",68,14,"Saint Mary's","WCC",46,"",-11,22,"3 over 14"
"785",785,"14-Mar-97",1997,"64","East",15,"Coppin St.","MEAC",78,2,"South Carolina","SEC",65,"",13,13,"15 over 2"
"786",786,"14-Mar-97",1997,"64","Midwest",1,"Minnesota","B10",78,16,"Texas St.","SB",46,"",-15,32,"1 over 16"
"787",787,"14-Mar-97",1997,"64","Southeast",6,"Illinois","B10",90,11,"USC","P12",77,"",-5,13,"6 over 11"
"788",788,"14-Mar-97",1997,"64","East",10,"Texas","B12",71,7,"Wisconsin","B10",58,"",3,13,"10 over 7"
"789",789,"15-Mar-97",1997,"32","West",4,"Saint Joseph's","A10",81,5,"Boston College","ACC",77,"1 OT",-1,4,"4 over 5"
"790",790,"15-Mar-97",1997,"32","Southeast",4,"Arizona","P12",73,12,"Charleston Southern","BSth",69,"",-8,4,"4 over 12"
"791",791,"15-Mar-97",1997,"32","Midwest",6,"Iowa St.","B12",67,3,"Cincinnati","Amer",66,"",3,1,"6 over 3"
"792",792,"15-Mar-97",1997,"32","East",1,"North Carolina","ACC",73,9,"Colorado","P12",56,"",-8,17,"1 over 9"
"793",793,"15-Mar-97",1997,"32","West",1,"Kentucky","SEC",75,8,"Iowa","B10",69,"",-7,6,"1 over 8"
"794",794,"15-Mar-97",1997,"32","Southeast",1,"Kansas","B12",75,8,"Purdue","B10",61,"",-7,14,"1 over 8"
"795",795,"15-Mar-97",1997,"32","East",5,"California","P12",75,4,"Villanova","BE",68,"",1,7,"5 over 4"
"796",796,"15-Mar-97",1997,"32","Midwest",2,"UCLA","P12",96,7,"Xavier","BE",83,"",-5,13,"2 over 7"
"797",797,"16-Mar-97",1997,"32","West",2,"Utah","P12",77,7,"Charlotte","CUSA",58,"",-5,19,"2 over 7"
"798",798,"16-Mar-97",1997,"32","East",10,"Texas","B12",82,15,"Coppin St.","MEAC",81,"",-5,1,"10 over 15"
"799",799,"16-Mar-97",1997,"32","Southeast",10,"Providence","BE",98,2,"Duke","ACC",87,"",8,11,"10 over 2"
"800",800,"16-Mar-97",1997,"32","Southeast",14,"Chattanooga","SC",75,6,"Illinois","B10",63,"",8,12,"14 over 6"
"801",801,"16-Mar-97",1997,"32","East",6,"Louisville","ACC",64,3,"New Mexico","MWC",63,"",3,1,"6 over 3"
"802",802,"16-Mar-97",1997,"32","Midwest",1,"Minnesota","B10",76,9,"Temple","Amer",57,"",-8,19,"1 over 9"
"803",803,"16-Mar-97",1997,"32","Midwest",4,"Clemson","ACC",65,5,"Tulsa","Amer",59,"",-1,6,"4 over 5"
"804",804,"16-Mar-97",1997,"32","West",6,"Stanford","P12",72,3,"Wake Forest","ACC",66,"",3,6,"6 over 3"
"805",805,"20-Mar-97",1997,"16","Midwest",1,"Minnesota","B10",90,4,"Clemson","ACC",84,"2 OT",-3,6,"1 over 4"
"806",806,"20-Mar-97",1997,"16","Midwest",2,"UCLA","P12",74,6,"Iowa St.","B12",73,"1 OT",-4,1,"2 over 6"
"807",807,"20-Mar-97",1997,"16","West",1,"Kentucky","SEC",83,4,"Saint Joseph's","A10",68,"",-3,15,"1 over 4"
"808",808,"20-Mar-97",1997,"16","West",2,"Utah","P12",82,6,"Stanford","P12",77,"1 OT",-4,5,"2 over 6"
"809",809,"21-Mar-97",1997,"16","East",1,"North Carolina","ACC",73,5,"California","P12",67,"",-4,6,"1 over 5"
"810",810,"21-Mar-97",1997,"16","Southeast",10,"Providence","BE",71,14,"Chattanooga","SC",65,"",-4,6,"10 over 14"
"811",811,"21-Mar-97",1997,"16","Southeast",4,"Arizona","P12",85,1,"Kansas","B12",82,"",3,3,"4 over 1"
"812",812,"21-Mar-97",1997,"16","East",6,"Louisville","ACC",78,10,"Texas","B12",63,"",-4,15,"6 over 10"
"813",813,"22-Mar-97",1997,"8","Midwest",1,"Minnesota","B10",80,2,"UCLA","P12",72,"",-1,8,"1 over 2"
"814",814,"22-Mar-97",1997,"8","West",1,"Kentucky","SEC",72,2,"Utah","P12",59,"",-1,13,"1 over 2"
"815",815,"23-Mar-97",1997,"8","East",1,"North Carolina","ACC",97,6,"Louisville","ACC",74,"",-5,23,"1 over 6"
"816",816,"23-Mar-97",1997,"8","Southeast",4,"Arizona","P12",96,10,"Providence","BE",92,"1 OT",-6,4,"4 over 10"
"817",817,"29-Mar-97",1997,"4","Final Four",1,"Kentucky","SEC",78,1,"Minnesota","B10",69,"",0,9,"1 over 1"
"818",818,"29-Mar-97",1997,"4","Final Four",4,"Arizona","P12",66,1,"North Carolina","ACC",58,"",3,8,"4 over 1"
"819",819,"31-Mar-97",1997,"Champ","Championship",4,"Arizona","P12",84,1,"Kentucky","SEC",79,"1 OT",3,5,"4 over 1"
"820",820,"12-Mar-98",1998,"64","East",4,"Michigan St.","B10",83,13,"Eastern Michigan","MAC",71,"",-9,12,"4 over 13"
"821",821,"12-Mar-98",1998,"64","East",2,"Connecticut","Amer",93,15,"Fairleigh Dickinson","NEC",85,"",-13,8,"2 over 15"
"822",822,"12-Mar-98",1998,"64","East",8,"Charlotte","CUSA",77,9,"Illinois Chicago","Horz",62,"",-1,15,"8 over 9"
"823",823,"12-Mar-98",1998,"64","East",1,"North Carolina","ACC",88,16,"Navy","Pat",52,"",-15,36,"1 over 16"
"824",824,"12-Mar-98",1998,"64","West",6,"Arkansas","SEC",74,11,"Nebraska","B10",65,"",-5,9,"6 over 11"
"825",825,"12-Mar-98",1998,"64","West",1,"Arizona","P12",99,16,"Nicholls St.","Slnd",60,"",-15,39,"1 over 16"
"826",826,"12-Mar-98",1998,"64","West",2,"Cincinnati","Amer",65,15,"Northern Arizona","BSky",62,"",-13,3,"2 over 15"
"827",827,"12-Mar-98",1998,"64","East",7,"Indiana","B10",94,10,"Oklahoma","B12",87,"1 OT",-3,7,"7 over 10"
"828",828,"12-Mar-98",1998,"64","West",3,"Utah","P12",85,14,"San Francisco","WCC",68,"",-11,17,"3 over 14"
"829",829,"12-Mar-98",1998,"64","West",5,"Illinois","B10",64,12,"South Alabama","SB",51,"",-7,13,"5 over 12"
"830",830,"12-Mar-98",1998,"64","East",14,"Richmond","A10",62,3,"South Carolina","SEC",61,"",11,1,"14 over 3"
"831",831,"12-Mar-98",1998,"64","West",10,"West Virginia","B12",82,7,"Temple","Amer",52,"",3,30,"10 over 7"
"832",832,"12-Mar-98",1998,"64","West",9,"Illinois St.","MVC",82,8,"Tennessee","SEC",81,"1 OT",1,1,"9 over 8"
"833",833,"12-Mar-98",1998,"64","East",5,"Princeton","Ivy",69,12,"UNLV","MWC",57,"",-7,12,"5 over 12"
"834",834,"12-Mar-98",1998,"64","West",4,"Maryland","B10",82,13,"Utah St.","MWC",68,"",-9,14,"4 over 13"
"835",835,"12-Mar-98",1998,"64","East",11,"Washington","P12",69,6,"Xavier","BE",68,"",5,1,"11 over 6"
"836",836,"13-Mar-98",1998,"64","South",4,"New Mexico","MWC",79,13,"Butler","BE",62,"",-9,17,"4 over 13"
"837",837,"13-Mar-98",1998,"64","Midwest",3,"Stanford","P12",67,14,"Charleston Southern","BSth",57,"",-11,10,"3 over 14"
"838",838,"13-Mar-98",1998,"64","Midwest",11,"Western Michigan","MAC",75,6,"Clemson","ACC",72,"",5,3,"11 over 6"
"839",839,"13-Mar-98",1998,"64","South",3,"Michigan","B10",80,14,"Davidson","A10",61,"",-11,19,"3 over 14"
"840",840,"13-Mar-98",1998,"64","Midwest",2,"Purdue","B10",95,15,"Delaware","CAA",56,"",-13,39,"2 over 15"
"841",841,"13-Mar-98",1998,"64","South",8,"Oklahoma St.","B12",74,9,"George Washington","A10",59,"",-1,15,"8 over 9"
"842",842,"13-Mar-98",1998,"64","South",5,"Syracuse","ACC",63,12,"Iona","MAAC",61,"",-7,2,"5 over 12"
"843",843,"13-Mar-98",1998,"64","South",10,"Saint Louis","A10",51,7,"Massachusetts","A10",46,"",3,5,"10 over 7"
"844",844,"13-Mar-98",1998,"64","South",6,"UCLA","P12",65,11,"Miami FL","ACC",62,"",-5,3,"6 over 11"
"845",845,"13-Mar-98",1998,"64","Midwest",13,"Valparaiso","Horz",70,4,"Mississippi","SEC",69,"",9,1,"13 over 4"
"846",846,"13-Mar-98",1998,"64","Midwest",8,"Rhode Island","A10",97,9,"Murray St.","OVC",74,"",-1,23,"8 over 9"
"847",847,"13-Mar-98",1998,"64","Midwest",1,"Kansas","B12",110,16,"Prairie View",NA,52,"",-15,58,"1 over 16"
"848",848,"13-Mar-98",1998,"64","South",1,"Duke","ACC",99,16,"Radford","BSth",63,"",-15,36,"1 over 16"
"849",849,"13-Mar-98",1998,"64","South",2,"Kentucky","SEC",82,15,"South Carolina St.","MEAC",67,"",-13,15,"2 over 15"
"850",850,"13-Mar-98",1998,"64","Midwest",10,"Detroit","Horz",66,7,"St. John's","BE",64,"",3,2,"10 over 7"
"851",851,"13-Mar-98",1998,"64","Midwest",12,"Florida St.","ACC",96,5,"TCU","B12",87,"",7,9,"12 over 5"
"852",852,"14-Mar-98",1998,"32","West",3,"Utah","P12",75,6,"Arkansas","SEC",69,"",-3,6,"3 over 6"
"853",853,"14-Mar-98",1998,"32","East",1,"North Carolina","ACC",93,8,"Charlotte","CUSA",83,"1 OT",-7,10,"1 over 8"
"854",854,"14-Mar-98",1998,"32","West",10,"West Virginia","B12",75,2,"Cincinnati","Amer",74,"",8,1,"10 over 2"
"855",855,"14-Mar-98",1998,"32","West",4,"Maryland","B10",67,5,"Illinois","B10",61,"",-1,6,"4 over 5"
"856",856,"14-Mar-98",1998,"32","West",1,"Arizona","P12",82,9,"Illinois St.","MVC",49,"",-8,33,"1 over 9"
"857",857,"14-Mar-98",1998,"32","East",2,"Connecticut","Amer",78,7,"Indiana","B10",68,"",-5,10,"2 over 7"
"858",858,"14-Mar-98",1998,"32","East",4,"Michigan St.","B10",63,5,"Princeton","Ivy",56,"",-1,7,"4 over 5"
"859",859,"14-Mar-98",1998,"32","East",11,"Washington","P12",87,14,"Richmond","A10",66,"",-3,21,"11 over 14"
"860",860,"15-Mar-98",1998,"32","Midwest",2,"Purdue","B10",80,10,"Detroit","Horz",65,"",-8,15,"2 over 10"
"861",861,"15-Mar-98",1998,"32","Midwest",13,"Valparaiso","Horz",83,12,"Florida St.","ACC",77,"1 OT",1,6,"13 over 12"
"862",862,"15-Mar-98",1998,"32","Midwest",8,"Rhode Island","A10",80,1,"Kansas","B12",75,"",7,5,"8 over 1"
"863",863,"15-Mar-98",1998,"32","South",6,"UCLA","P12",85,3,"Michigan","B10",82,"",3,3,"6 over 3"
"864",864,"15-Mar-98",1998,"32","South",5,"Syracuse","ACC",56,4,"New Mexico","MWC",46,"",1,10,"5 over 4"
"865",865,"15-Mar-98",1998,"32","South",1,"Duke","ACC",79,8,"Oklahoma St.","B12",73,"",-7,6,"1 over 8"
"866",866,"15-Mar-98",1998,"32","South",2,"Kentucky","SEC",88,10,"Saint Louis","A10",61,"",-8,27,"2 over 10"
"867",867,"15-Mar-98",1998,"32","Midwest",3,"Stanford","P12",83,11,"Western Michigan","MAC",65,"",-8,18,"3 over 11"
"868",868,"19-Mar-98",1998,"16","West",1,"Arizona","P12",87,4,"Maryland","B10",79,"",-3,8,"1 over 4"
"869",869,"19-Mar-98",1998,"16","East",1,"North Carolina","ACC",73,4,"Michigan St.","B10",58,"",-3,15,"1 over 4"
"870",870,"19-Mar-98",1998,"16","East",2,"Connecticut","Amer",75,11,"Washington","P12",74,"",-9,1,"2 over 11"
"871",871,"19-Mar-98",1998,"16","West",3,"Utah","P12",65,10,"West Virginia","B12",62,"",-7,3,"3 over 10"
"872",872,"20-Mar-98",1998,"16","Midwest",3,"Stanford","P12",67,2,"Purdue","B10",59,"",1,8,"3 over 2"
"873",873,"20-Mar-98",1998,"16","South",1,"Duke","ACC",80,5,"Syracuse","ACC",67,"",-4,13,"1 over 5"
"874",874,"20-Mar-98",1998,"16","South",2,"Kentucky","SEC",94,6,"UCLA","P12",68,"",-4,26,"2 over 6"
"875",875,"20-Mar-98",1998,"16","Midwest",8,"Rhode Island","A10",74,13,"Valparaiso","Horz",68,"",-5,6,"8 over 13"
"876",876,"21-Mar-98",1998,"8","West",3,"Utah","P12",76,1,"Arizona","P12",51,"",2,25,"3 over 1"
"877",877,"21-Mar-98",1998,"8","East",1,"North Carolina","ACC",75,2,"Connecticut","Amer",64,"",-1,11,"1 over 2"
"878",878,"22-Mar-98",1998,"8","South",2,"Kentucky","SEC",86,1,"Duke","ACC",84,"",1,2,"2 over 1"
"879",879,"22-Mar-98",1998,"8","Midwest",3,"Stanford","P12",79,8,"Rhode Island","A10",77,"",-5,2,"3 over 8"
"880",880,"28-Mar-98",1998,"4","Final Four",3,"Utah","P12",65,1,"North Carolina","ACC",59,"",2,6,"3 over 1"
"881",881,"28-Mar-98",1998,"4","Final Four",2,"Kentucky","SEC",86,3,"Stanford","P12",85,"1 OT",-1,1,"2 over 3"
"882",882,"30-Mar-98",1998,"Champ","Championship",2,"Kentucky","SEC",78,3,"Utah","P12",69,"",-1,9,"2 over 3"
"883",883,"11-Mar-99",1999,"64","West",2,"Stanford","P12",69,15,"Alcorn St.","SWAC",57,"",-13,12,"2 over 15"
"884",884,"11-Mar-99",1999,"64","South",6,"Indiana","B10",108,11,"George Washington","A10",88,"",-5,20,"6 over 11"
"885",885,"11-Mar-99",1999,"64","South",10,"Creighton","BE",62,7,"Louisville","ACC",58,"",3,4,"10 over 7"
"886",886,"11-Mar-99",1999,"64","West",10,"Gonzaga","WCC",75,7,"Minnesota","B10",63,"",3,12,"10 over 7"
"887",887,"11-Mar-99",1999,"64","West",9,"New Mexico","MWC",61,8,"Missouri","SEC",59,"",1,2,"9 over 8"
"888",888,"11-Mar-99",1999,"64","South",4,"Ohio St.","B10",72,13,"Murray St.","OVC",58,"",-9,14,"4 over 13"
"889",889,"11-Mar-99",1999,"64","West",14,"Weber St.","BSky",76,3,"North Carolina","ACC",74,"",11,2,"14 over 3"
"890",890,"11-Mar-99",1999,"64","West",6,"Florida","SEC",75,11,"Penn","Ivy",61,"",-5,14,"6 over 11"
"891",891,"11-Mar-99",1999,"64","South",3,"St. John's","BE",69,14,"Samford","SC",43,"",-11,26,"3 over 14"
"892",892,"11-Mar-99",1999,"64","West",4,"Arkansas","SEC",94,13,"Siena","MAAC",80,"",-9,14,"4 over 13"
"893",893,"11-Mar-99",1999,"64","South",9,"Oklahoma St.","B12",69,8,"Syracuse","ACC",61,"",1,8,"9 over 8"
"894",894,"11-Mar-99",1999,"64","West",5,"Iowa","B10",77,12,"UAB","CUSA",64,"",-7,13,"5 over 12"
"895",895,"11-Mar-99",1999,"64","South",12,"Detroit","Horz",56,5,"UCLA","P12",53,"",7,3,"12 over 5"
"896",896,"11-Mar-99",1999,"64","West",1,"Connecticut","Amer",91,16,"UTSA","CUSA",66,"",-15,25,"1 over 16"
"897",897,"11-Mar-99",1999,"64","South",2,"Maryland","B10",82,15,"Valparaiso","Horz",60,"",-13,22,"2 over 15"
"898",898,"11-Mar-99",1999,"64","South",1,"Auburn","SEC",80,16,"Winthrop","BSth",41,"",-15,39,"1 over 16"
"899",899,"12-Mar-99",1999,"64","Midwest",13,"Oklahoma","B12",61,4,"Arizona","P12",60,"",9,1,"13 over 4"
"900",900,"12-Mar-99",1999,"64","Midwest",2,"Utah","P12",80,15,"Arkansas St.","SB",58,"",-13,22,"2 over 15"
"901",901,"12-Mar-99",1999,"64","East",9,"Tulsa","Amer",62,8,"Charleston Southern","BSth",53,"",1,9,"9 over 8"
"902",902,"12-Mar-99",1999,"64","East",4,"Tennessee","SEC",62,13,"Delaware","CAA",52,"",-9,10,"4 over 13"
"903",903,"12-Mar-99",1999,"64","Midwest",6,"Kansas","B12",95,11,"Evansville","MVC",74,"",-5,21,"6 over 11"
"904",904,"12-Mar-99",1999,"64","East",1,"Duke","ACC",99,16,"Florida A&M","MEAC",58,"",-15,41,"1 over 16"
"905",905,"12-Mar-99",1999,"64","East",3,"Cincinnati","Amer",72,14,"George Mason","A10",48,"",-11,24,"3 over 14"
"906",906,"12-Mar-99",1999,"64","East",6,"Temple","Amer",61,11,"Kent St.","MAC",54,"",-5,7,"6 over 11"
"907",907,"12-Mar-99",1999,"64","East",2,"Miami FL","ACC",75,15,"Lafayette","Pat",54,"",-13,21,"2 over 15"
"908",908,"12-Mar-99",1999,"64","Midwest",1,"Michigan St.","B10",76,16,"Mount St. Mary's","NEC",53,"",-15,23,"1 over 16"
"909",909,"12-Mar-99",1999,"64","Midwest",3,"Kentucky","SEC",82,14,"New Mexico St.","WAC",60,"",-11,22,"3 over 14"
"910",910,"12-Mar-99",1999,"64","Midwest",5,"Charlotte","CUSA",81,12,"Rhode Island","A10",70,"1 OT",-7,11,"5 over 12"
"911",911,"12-Mar-99",1999,"64","East",10,"Purdue","B10",58,7,"Texas","B12",54,"",3,4,"10 over 7"
"912",912,"12-Mar-99",1999,"64","Midwest",9,"Mississippi","SEC",72,8,"Villanova","BE",70,"",1,2,"9 over 8"
"913",913,"12-Mar-99",1999,"64","Midwest",10,"Miami OH","MAC",59,7,"Washington","P12",58,"",3,1,"10 over 7"
"914",914,"12-Mar-99",1999,"64","East",12,"Missouri St.","MVC",43,5,"Wisconsin","B10",32,"",7,11,"12 over 5"
"915",915,"13-Mar-99",1999,"32","West",5,"Iowa","B10",82,4,"Arkansas","SEC",72,"",1,10,"5 over 4"
"916",916,"13-Mar-99",1999,"32","South",2,"Maryland","B10",75,10,"Creighton","BE",63,"",-8,12,"2 over 10"
"917",917,"13-Mar-99",1999,"32","South",4,"Ohio St.","B10",75,12,"Detroit","Horz",44,"",-8,31,"4 over 12"
"918",918,"13-Mar-99",1999,"32","South",3,"St. John's","BE",86,6,"Indiana","B10",61,"",-3,25,"3 over 6"
"919",919,"13-Mar-99",1999,"32","West",1,"Connecticut","Amer",78,9,"New Mexico","MWC",56,"",-8,22,"1 over 9"
"920",920,"13-Mar-99",1999,"32","South",1,"Auburn","SEC",81,9,"Oklahoma St.","B12",74,"",-8,7,"1 over 9"
"921",921,"13-Mar-99",1999,"32","West",10,"Gonzaga","WCC",82,2,"Stanford","P12",74,"",8,8,"10 over 2"
"922",922,"13-Mar-99",1999,"32","West",6,"Florida","SEC",82,14,"Weber St.","BSky",74,"1 OT",-8,8,"6 over 14"
"923",923,"14-Mar-99",1999,"32","Midwest",13,"Oklahoma","B12",85,5,"Charlotte","CUSA",72,"",8,13,"13 over 5"
"924",924,"14-Mar-99",1999,"32","East",6,"Temple","Amer",64,3,"Cincinnati","Amer",54,"",3,10,"6 over 3"
"925",925,"14-Mar-99",1999,"32","Midwest",3,"Kentucky","SEC",92,6,"Kansas","B12",88,"1 OT",-3,4,"3 over 6"
"926",926,"14-Mar-99",1999,"32","East",10,"Purdue","B10",73,2,"Miami FL","ACC",63,"",8,10,"10 over 2"
"927",927,"14-Mar-99",1999,"32","Midwest",1,"Michigan St.","B10",74,9,"Mississippi","SEC",66,"",-8,8,"1 over 9"
"928",928,"14-Mar-99",1999,"32","East",12,"Missouri St.","MVC",81,4,"Tennessee","SEC",51,"",8,30,"12 over 4"
"929",929,"14-Mar-99",1999,"32","East",1,"Duke","ACC",97,9,"Tulsa","Amer",56,"",-8,41,"1 over 9"
"930",930,"14-Mar-99",1999,"32","Midwest",10,"Miami OH","MAC",66,2,"Utah","P12",58,"",8,8,"10 over 2"
"931",931,"18-Mar-99",1999,"16","South",4,"Ohio St.","B10",72,1,"Auburn","SEC",64,"",3,8,"4 over 1"
"932",932,"18-Mar-99",1999,"16","West",10,"Gonzaga","WCC",73,6,"Florida","SEC",72,"",4,1,"10 over 6"
"933",933,"18-Mar-99",1999,"16","West",1,"Connecticut","Amer",78,5,"Iowa","B10",68,"",-4,10,"1 over 5"
"934",934,"18-Mar-99",1999,"16","South",3,"St. John's","BE",76,2,"Maryland","B10",62,"",1,14,"3 over 2"
"935",935,"19-Mar-99",1999,"16","Midwest",3,"Kentucky","SEC",58,10,"Miami OH","MAC",43,"",-7,15,"3 over 10"
"936",936,"19-Mar-99",1999,"16","East",1,"Duke","ACC",78,12,"Missouri St.","MVC",61,"",-11,17,"1 over 12"
"937",937,"19-Mar-99",1999,"16","Midwest",1,"Michigan St.","B10",54,13,"Oklahoma","B12",46,"",-12,8,"1 over 13"
"938",938,"19-Mar-99",1999,"16","East",6,"Temple","Amer",77,10,"Purdue","B10",55,"",-4,22,"6 over 10"
"939",939,"20-Mar-99",1999,"8","West",1,"Connecticut","Amer",67,10,"Gonzaga","WCC",62,"",-9,5,"1 over 10"
"940",940,"20-Mar-99",1999,"8","South",4,"Ohio St.","B10",77,3,"St. John's","BE",74,"",1,3,"4 over 3"
"941",941,"21-Mar-99",1999,"8","Midwest",1,"Michigan St.","B10",73,3,"Kentucky","SEC",66,"",-2,7,"1 over 3"
"942",942,"21-Mar-99",1999,"8","East",1,"Duke","ACC",85,6,"Temple","Amer",64,"",-5,21,"1 over 6"
"943",943,"27-Mar-99",1999,"4","Final Four",1,"Duke","ACC",68,1,"Michigan St.","B10",62,"",0,6,"1 over 1"
"944",944,"27-Mar-99",1999,"4","Final Four",1,"Connecticut","Amer",64,4,"Ohio St.","B10",58,"",-3,6,"1 over 4"
"945",945,"29-Mar-99",1999,"Champ","Championship",1,"Connecticut","Amer",77,1,"Duke","ACC",74,"",0,3,"1 over 1"
"946",946,"16-Mar-00",2000,"64","Midwest",6,"UCLA","P12",65,11,"Ball St.","MAC",57,"",-5,8,"6 over 11"
"947",947,"16-Mar-00",2000,"64","Midwest",2,"Iowa St.","B12",88,15,"Central Connecticut","NEC",78,"",-13,10,"2 over 15"
"948",948,"16-Mar-00",2000,"64","Midwest",7,"Auburn","SEC",72,10,"Creighton","BE",69,"",-3,3,"7 over 10"
"949",949,"16-Mar-00",2000,"64","West",6,"Purdue","B10",62,11,"Dayton","A10",61,"",-5,1,"6 over 11"
"950",950,"16-Mar-00",2000,"64","West",8,"Wisconsin","B10",66,9,"Fresno St.","MWC",56,"",-1,10,"8 over 9"
"951",951,"16-Mar-00",2000,"64","West",5,"Texas","B12",77,12,"Indiana St.","MVC",61,"",-7,16,"5 over 12"
"952",952,"16-Mar-00",2000,"64","Midwest",3,"Maryland","B10",74,14,"Iona","MAAC",59,"",-11,15,"3 over 14"
"953",953,"16-Mar-00",2000,"64","West",1,"Arizona","P12",71,16,"Jackson St.","SWAC",47,"",-15,24,"1 over 16"
"954",954,"16-Mar-00",2000,"64","West",10,"Gonzaga","WCC",77,7,"Louisville","ACC",66,"",3,11,"10 over 7"
"955",955,"16-Mar-00",2000,"64","West",2,"St. John's","BE",61,15,"Northern Arizona","BSky",56,"",-13,5,"2 over 15"
"956",956,"16-Mar-00",2000,"64","Midwest",8,"Utah","P12",48,9,"Saint Louis","A10",45,"",-1,3,"8 over 9"
"957",957,"16-Mar-00",2000,"64","Midwest",4,"Syracuse","ACC",79,13,"Samford","SC",65,"",-9,14,"4 over 13"
"958",958,"16-Mar-00",2000,"64","West",4,"LSU","SEC",64,13,"Southeast Missouri St.","OVC",61,"",-9,3,"4 over 13"
"959",959,"16-Mar-00",2000,"64","Midwest",5,"Kentucky","SEC",85,12,"St. Bonaventure","A10",80,"2 OT",-7,5,"5 over 12"
"960",960,"16-Mar-00",2000,"64","Midwest",1,"Michigan St.","B10",65,16,"Valparaiso","Horz",38,"",-15,27,"1 over 16"
"961",961,"16-Mar-00",2000,"64","West",3,"Oklahoma","B12",74,14,"Winthrop","BSth",60,"",-11,14,"3 over 14"
"962",962,"17-Mar-00",2000,"64","South",3,"Ohio St.","B10",87,14,"Appalachian St.","SB",61,"",-11,26,"3 over 14"
"963",963,"17-Mar-00",2000,"64","South",6,"Miami FL","ACC",75,11,"Arkansas","SEC",71,"",-5,4,"6 over 11"
"964",964,"17-Mar-00",2000,"64","East",5,"Florida","SEC",69,12,"Butler","BE",68,"1 OT",-7,1,"5 over 12"
"965",965,"17-Mar-00",2000,"64","East",8,"Kansas","B12",81,9,"DePaul","BE",77,"1 OT",-1,4,"8 over 9"
"966",966,"17-Mar-00",2000,"64","East",3,"Oklahoma St.","B12",86,14,"Hofstra","CAA",66,"",-11,20,"3 over 14"
"967",967,"17-Mar-00",2000,"64","East",11,"Pepperdine","WCC",77,6,"Indiana","B10",57,"",5,20,"11 over 6"
"968",968,"17-Mar-00",2000,"64","East",2,"Temple","Amer",73,15,"Lafayette","Pat",47,"",-13,26,"2 over 15"
"969",969,"17-Mar-00",2000,"64","East",1,"Duke","ACC",82,16,"Lamar","Slnd",55,"",-15,27,"1 over 16"
"970",970,"17-Mar-00",2000,"64","South",4,"Tennessee","SEC",63,13,"Louisiana Lafayette","SB",58,"",-9,5,"4 over 13"
"971",971,"17-Mar-00",2000,"64","South",8,"North Carolina","ACC",84,9,"Missouri","SEC",70,"",-1,14,"8 over 9"
"972",972,"17-Mar-00",2000,"64","East",10,"Seton Hall","BE",72,7,"Oregon","P12",71,"1 OT",3,1,"10 over 7"
"973",973,"17-Mar-00",2000,"64","East",4,"Illinois","B10",68,13,"Penn","Ivy",58,"",-9,10,"4 over 13"
"974",974,"17-Mar-00",2000,"64","South",1,"Stanford","P12",84,16,"South Carolina St.","MEAC",65,"",-15,19,"1 over 16"
"975",975,"17-Mar-00",2000,"64","South",2,"Cincinnati","Amer",64,15,"UNC Wilmington","CAA",47,"",-13,17,"2 over 15"
"976",976,"17-Mar-00",2000,"64","South",7,"Tulsa","Amer",89,10,"UNLV","MWC",62,"",-3,27,"7 over 10"
"977",977,"17-Mar-00",2000,"64","South",5,"Connecticut","Amer",75,12,"Utah St.","MWC",67,"",-7,8,"5 over 12"
"978",978,"18-Mar-00",2000,"32","West",8,"Wisconsin","B10",66,1,"Arizona","P12",59,"",7,7,"8 over 1"
"979",979,"18-Mar-00",2000,"32","Midwest",2,"Iowa St.","B12",79,7,"Auburn","SEC",60,"",-5,19,"2 over 7"
"980",980,"18-Mar-00",2000,"32","Midwest",4,"Syracuse","ACC",52,5,"Kentucky","SEC",50,"",-1,2,"4 over 5"
"981",981,"18-Mar-00",2000,"32","Midwest",6,"UCLA","P12",105,3,"Maryland","B10",70,"",3,35,"6 over 3"
"982",982,"18-Mar-00",2000,"32","West",6,"Purdue","B10",66,3,"Oklahoma","B12",62,"",3,4,"6 over 3"
"983",983,"18-Mar-00",2000,"32","West",10,"Gonzaga","WCC",82,2,"St. John's","BE",76,"",8,6,"10 over 2"
"984",984,"18-Mar-00",2000,"32","West",4,"LSU","SEC",72,5,"Texas","B12",67,"",-1,5,"4 over 5"
"985",985,"18-Mar-00",2000,"32","Midwest",1,"Michigan St.","B10",73,8,"Utah","P12",61,"",-7,12,"1 over 8"
"986",986,"19-Mar-00",2000,"32","South",7,"Tulsa","Amer",69,2,"Cincinnati","Amer",61,"",5,8,"7 over 2"
"987",987,"19-Mar-00",2000,"32","South",4,"Tennessee","SEC",65,5,"Connecticut","Amer",51,"",-1,14,"4 over 5"
"988",988,"19-Mar-00",2000,"32","East",5,"Florida","SEC",93,4,"Illinois","B10",76,"",1,17,"5 over 4"
"989",989,"19-Mar-00",2000,"32","East",1,"Duke","ACC",69,8,"Kansas","B12",64,"",-7,5,"1 over 8"
"990",990,"19-Mar-00",2000,"32","South",6,"Miami FL","ACC",75,3,"Ohio St.","B10",62,"",3,13,"6 over 3"
"991",991,"19-Mar-00",2000,"32","East",3,"Oklahoma St.","B12",75,11,"Pepperdine","WCC",67,"",-8,8,"3 over 11"
"992",992,"19-Mar-00",2000,"32","South",8,"North Carolina","ACC",60,1,"Stanford","P12",53,"",7,7,"8 over 1"
"993",993,"19-Mar-00",2000,"32","East",10,"Seton Hall","BE",67,2,"Temple","Amer",65,"1 OT",8,2,"10 over 2"
"994",994,"23-Mar-00",2000,"16","West",6,"Purdue","B10",75,10,"Gonzaga","WCC",66,"",-4,9,"6 over 10"
"995",995,"23-Mar-00",2000,"16","West",8,"Wisconsin","B10",61,4,"LSU","SEC",48,"",4,13,"8 over 4"
"996",996,"23-Mar-00",2000,"16","Midwest",1,"Michigan St.","B10",75,4,"Syracuse","ACC",58,"",-3,17,"1 over 4"
"997",997,"23-Mar-00",2000,"16","Midwest",2,"Iowa St.","B12",80,6,"UCLA","P12",56,"",-4,24,"2 over 6"
"998",998,"24-Mar-00",2000,"16","East",5,"Florida","SEC",87,1,"Duke","ACC",78,"",4,9,"5 over 1"
"999",999,"24-Mar-00",2000,"16","South",7,"Tulsa","Amer",80,6,"Miami FL","ACC",71,"",1,9,"7 over 6"
"1000",1000,"24-Mar-00",2000,"16","East",3,"Oklahoma St.","B12",68,10,"Seton Hall","BE",66,"",-7,2,"3 over 10"
"1001",1001,"24-Mar-00",2000,"16","South",8,"North Carolina","ACC",74,4,"Tennessee","SEC",69,"",4,5,"8 over 4"
"1002",1002,"25-Mar-00",2000,"8","Midwest",1,"Michigan St.","B10",75,2,"Iowa St.","B12",64,"",-1,11,"1 over 2"
"1003",1003,"25-Mar-00",2000,"8","West",8,"Wisconsin","B10",64,6,"Purdue","B10",60,"",2,4,"8 over 6"
"1004",1004,"26-Mar-00",2000,"8","East",5,"Florida","SEC",77,3,"Oklahoma St.","B12",65,"",2,12,"5 over 3"
"1005",1005,"26-Mar-00",2000,"8","South",8,"North Carolina","ACC",59,7,"Tulsa","Amer",55,"",1,4,"8 over 7"
"1006",1006,"1-Apr-00",2000,"4","Final Four",5,"Florida","SEC",71,8,"North Carolina","ACC",59,"",-3,12,"5 over 8"
"1007",1007,"1-Apr-00",2000,"4","Final Four",1,"Michigan St.","B10",53,8,"Wisconsin","B10",41,"",-7,12,"1 over 8"
"1008",1008,"3-Apr-00",2000,"Champ","Championship",1,"Michigan St.","B10",89,5,"Florida","SEC",76,"",-4,13,"1 over 5"
"1009",1009,"13-Mar-01",2001,"Play-in","Midwest",16,"Northwestern St.","Slnd",71,16,"Winthrop","BSth",67,"",0,4,"16 over 16"
"1010",1010,"15-Mar-01",2001,"64","West",10,"Georgetown","BE",63,7,"Arkansas","SEC",61,"",3,2,"10 over 7"
"1011",1011,"15-Mar-01",2001,"64","West",5,"Cincinnati","Amer",84,12,"BYU","WCC",59,"",-7,25,"5 over 12"
"1012",1012,"15-Mar-01",2001,"64","East",7,"Iowa","B10",69,10,"Creighton","BE",56,"",-3,13,"7 over 10"
"1013",1013,"15-Mar-01",2001,"64","West",3,"Maryland","B10",83,14,"George Mason","A10",80,"",-11,3,"3 over 14"
"1014",1014,"15-Mar-01",2001,"64","East",9,"Missouri","SEC",70,8,"Georgia","SEC",68,"",1,2,"9 over 8"
"1015",1015,"15-Mar-01",2001,"64","West",9,"Saint Joseph's","A10",66,8,"Georgia Tech","ACC",62,"",1,4,"9 over 8"
"1016",1016,"15-Mar-01",2001,"64","East",4,"UCLA","P12",61,13,"Hofstra","CAA",48,"",-9,13,"4 over 13"
"1017",1017,"15-Mar-01",2001,"64","East",2,"Kentucky","SEC",72,15,"Holy Cross","Pat",68,"",-13,4,"2 over 15"
"1018",1018,"15-Mar-01",2001,"64","West",13,"Kent St.","MAC",77,4,"Indiana","B10",73,"",9,4,"13 over 4"
"1019",1019,"15-Mar-01",2001,"64","West",15,"Hampton","MEAC",58,2,"Iowa St.","B12",57,"",13,1,"15 over 2"
"1020",1020,"15-Mar-01",2001,"64","East",1,"Duke","ACC",95,16,"Monmouth","MAAC",52,"",-15,43,"1 over 16"
"1021",1021,"15-Mar-01",2001,"64","West",1,"Stanford","P12",89,16,"North Carolina Greensboro",NA,60,"",-15,29,"1 over 16"
"1022",1022,"15-Mar-01",2001,"64","East",12,"Utah St.","MWC",77,5,"Ohio St.","B10",68,"1 OT",7,9,"12 over 5"
"1023",1023,"15-Mar-01",2001,"64","East",6,"USC","P12",69,11,"Oklahoma St.","B12",54,"",-5,15,"6 over 11"
"1024",1024,"15-Mar-01",2001,"64","East",3,"Boston College","ACC",68,14,"Southern Utah","BSky",65,"",-11,3,"3 over 14"
"1025",1025,"15-Mar-01",2001,"64","West",11,"Georgia St.","SB",50,6,"Wisconsin","B10",49,"1 OT",5,1,"11 over 6"
"1026",1026,"16-Mar-01",2001,"64","South",1,"Michigan St.","B10",69,16,"Alabama St.","SWAC",35,"",-15,34,"1 over 16"
"1027",1027,"16-Mar-01",2001,"64","Midwest",4,"Kansas","B12",99,13,"Cal St. Northridge","BW",75,"",-9,24,"4 over 13"
"1028",1028,"16-Mar-01",2001,"64","South",9,"Fresno St.","MWC",82,8,"California","P12",70,"",1,12,"9 over 8"
"1029",1029,"16-Mar-01",2001,"64","Midwest",2,"Arizona","P12",101,15,"Eastern Illinois","OVC",76,"",-13,25,"2 over 15"
"1030",1030,"16-Mar-01",2001,"64","Midwest",5,"Syracuse","ACC",79,12,"Hawaii","BW",69,"",-7,10,"5 over 12"
"1031",1031,"16-Mar-01",2001,"64","Midwest",3,"Mississippi","SEC",72,14,"Iona","MAAC",70,"",-11,2,"3 over 14"
"1032",1032,"16-Mar-01",2001,"64","Midwest",1,"Illinois","B10",96,16,"Northwestern St.","Slnd",54,"",-15,42,"1 over 16"
"1033",1033,"16-Mar-01",2001,"64","South",13,"Indiana St.","MVC",70,4,"Oklahoma","B12",68,"1 OT",9,2,"13 over 4"
"1034",1034,"16-Mar-01",2001,"64","South",2,"North Carolina","ACC",70,15,"Princeton","Ivy",48,"",-13,22,"2 over 15"
"1035",1035,"16-Mar-01",2001,"64","South",7,"Penn St.","B10",69,10,"Providence","BE",59,"",-3,10,"7 over 10"
"1036",1036,"16-Mar-01",2001,"64","Midwest",9,"Charlotte","CUSA",70,8,"Tennessee","SEC",63,"",1,7,"9 over 8"
"1037",1037,"16-Mar-01",2001,"64","South",11,"Temple","Amer",79,6,"Texas","B12",65,"",5,14,"11 over 6"
"1038",1038,"16-Mar-01",2001,"64","South",12,"Gonzaga","WCC",86,5,"Virginia","ACC",85,"",7,1,"12 over 5"
"1039",1039,"16-Mar-01",2001,"64","Midwest",10,"Butler","BE",79,7,"Wake Forest","ACC",63,"",3,16,"10 over 7"
"1040",1040,"16-Mar-01",2001,"64","South",3,"Florida","SEC",69,14,"Western Kentucky","CUSA",56,"",-11,13,"3 over 14"
"1041",1041,"16-Mar-01",2001,"64","Midwest",6,"Notre Dame","ACC",83,11,"Xavier","BE",71,"",-5,12,"6 over 11"
"1042",1042,"17-Mar-01",2001,"32","East",6,"USC","P12",74,3,"Boston College","ACC",71,"",3,3,"6 over 3"
"1043",1043,"17-Mar-01",2001,"32","West",3,"Maryland","B10",79,11,"Georgia St.","SB",60,"",-8,19,"3 over 11"
"1044",1044,"17-Mar-01",2001,"32","West",10,"Georgetown","BE",76,15,"Hampton","MEAC",57,"",-5,19,"10 over 15"
"1045",1045,"17-Mar-01",2001,"32","East",2,"Kentucky","SEC",92,7,"Iowa","B10",79,"",-5,13,"2 over 7"
"1046",1046,"17-Mar-01",2001,"32","West",5,"Cincinnati","Amer",66,13,"Kent St.","MAC",43,"",-8,23,"5 over 13"
"1047",1047,"17-Mar-01",2001,"32","East",1,"Duke","ACC",94,9,"Missouri","SEC",81,"",-8,13,"1 over 9"
"1048",1048,"17-Mar-01",2001,"32","West",1,"Stanford","P12",90,9,"Saint Joseph's","A10",83,"",-8,7,"1 over 9"
"1049",1049,"17-Mar-01",2001,"32","East",4,"UCLA","P12",75,12,"Utah St.","MWC",70,"",-8,5,"4 over 12"
"1050",1050,"18-Mar-01",2001,"32","Midwest",2,"Arizona","P12",73,10,"Butler","BE",52,"",-8,21,"2 over 10"
"1051",1051,"18-Mar-01",2001,"32","Midwest",1,"Illinois","B10",79,9,"Charlotte","CUSA",61,"",-8,18,"1 over 9"
"1052",1052,"18-Mar-01",2001,"32","South",11,"Temple","Amer",75,3,"Florida","SEC",54,"",8,21,"11 over 3"
"1053",1053,"18-Mar-01",2001,"32","South",1,"Michigan St.","B10",81,9,"Fresno St.","MWC",65,"",-8,16,"1 over 9"
"1054",1054,"18-Mar-01",2001,"32","South",12,"Gonzaga","WCC",85,13,"Indiana St.","MVC",68,"",-1,17,"12 over 13"
"1055",1055,"18-Mar-01",2001,"32","South",7,"Penn St.","B10",82,2,"North Carolina","ACC",74,"",5,8,"7 over 2"
"1056",1056,"18-Mar-01",2001,"32","Midwest",3,"Mississippi","SEC",59,6,"Notre Dame","ACC",56,"",-3,3,"3 over 6"
"1057",1057,"18-Mar-01",2001,"32","Midwest",4,"Kansas","B12",87,5,"Syracuse","ACC",58,"",-1,29,"4 over 5"
"1058",1058,"22-Mar-01",2001,"16","West",1,"Stanford","P12",78,5,"Cincinnati","Amer",65,"",-4,13,"1 over 5"
"1059",1059,"22-Mar-01",2001,"16","West",3,"Maryland","B10",76,10,"Georgetown","BE",66,"",-7,10,"3 over 10"
"1060",1060,"22-Mar-01",2001,"16","East",6,"USC","P12",80,2,"Kentucky","SEC",76,"",4,4,"6 over 2"
"1061",1061,"22-Mar-01",2001,"16","East",1,"Duke","ACC",76,4,"UCLA","P12",63,"",-3,13,"1 over 4"
"1062",1062,"23-Mar-01",2001,"16","South",1,"Michigan St.","B10",77,12,"Gonzaga","WCC",62,"",-11,15,"1 over 12"
"1063",1063,"23-Mar-01",2001,"16","Midwest",1,"Illinois","B10",80,4,"Kansas","B12",64,"",-3,16,"1 over 4"
"1064",1064,"23-Mar-01",2001,"16","Midwest",2,"Arizona","P12",66,3,"Mississippi","SEC",56,"",-1,10,"2 over 3"
"1065",1065,"23-Mar-01",2001,"16","South",11,"Temple","Amer",84,7,"Penn St.","B10",72,"",4,12,"11 over 7"
"1066",1066,"24-Mar-01",2001,"8","West",3,"Maryland","B10",87,1,"Stanford","P12",73,"",2,14,"3 over 1"
"1067",1067,"24-Mar-01",2001,"8","East",1,"Duke","ACC",79,6,"USC","P12",69,"",-5,10,"1 over 6"
"1068",1068,"25-Mar-01",2001,"8","Midwest",2,"Arizona","P12",87,1,"Illinois","B10",81,"",1,6,"2 over 1"
"1069",1069,"25-Mar-01",2001,"8","South",1,"Michigan St.","B10",69,11,"Temple","Amer",62,"",-10,7,"1 over 11"
"1070",1070,"31-Mar-01",2001,"4","Final Four",1,"Duke","ACC",95,3,"Maryland","B10",84,"",-2,11,"1 over 3"
"1071",1071,"31-Mar-01",2001,"4","Final Four",2,"Arizona","P12",80,1,"Michigan St.","B10",61,"",1,19,"2 over 1"
"1072",1072,"2-Apr-01",2001,"Champ","Championship",1,"Duke","ACC",82,2,"Arizona","P12",72,"",-1,10,"1 over 2"
"1073",1073,"12-Mar-02",2002,"Play-in","East",16,"Siena","MAAC",81,16,"Alcorn St.","SWAC",77,"",0,4,"16 over 16"
"1074",1074,"14-Mar-02",2002,"64","South",8,"Notre Dame","ACC",82,9,"Charlotte","CUSA",63,"",-1,19,"8 over 9"
"1075",1075,"14-Mar-02",2002,"64","West",4,"Ohio St.","B10",69,13,"Davidson","A10",64,"",-9,5,"4 over 13"
"1076",1076,"14-Mar-02",2002,"64","South",2,"Alabama","SEC",86,15,"Florida Atlantic","CUSA",78,"",-13,8,"2 over 15"
"1077",1077,"14-Mar-02",2002,"64","West",11,"Wyoming","MWC",73,6,"Gonzaga","WCC",66,"",5,7,"11 over 6"
"1078",1078,"14-Mar-02",2002,"64","Midwest",1,"Kansas","B12",70,16,"Holy Cross","Pat",59,"",-15,11,"1 over 16"
"1079",1079,"14-Mar-02",2002,"64","East",12,"Tulsa","Amer",71,5,"Marquette","BE",69,"",7,2,"12 over 5"
"1080",1080,"14-Mar-02",2002,"64","West",12,"Missouri","SEC",93,5,"Miami FL","ACC",80,"",7,13,"12 over 5"
"1081",1081,"14-Mar-02",2002,"64","Midwest",2,"Oregon","P12",81,15,"Montana","BSky",62,"",-13,19,"2 over 15"
"1082",1082,"14-Mar-02",2002,"64","South",10,"Kent St.","MAC",69,7,"Oklahoma St.","B12",61,"",3,8,"10 over 7"
"1083",1083,"14-Mar-02",2002,"64","Midwest",7,"Wake Forest","ACC",83,10,"Pepperdine","WCC",74,"",-3,9,"7 over 10"
"1084",1084,"14-Mar-02",2002,"64","West",3,"Arizona","P12",86,14,"UC Santa Barbara","BW",81,"",-11,5,"3 over 14"
"1085",1085,"14-Mar-02",2002,"64","South",13,"UNC Wilmington","CAA",93,4,"USC","P12",89,"1 OT",9,4,"13 over 4"
"1086",1086,"14-Mar-02",2002,"64","South",5,"Indiana","B10",75,12,"Utah","P12",56,"",-7,19,"5 over 12"
"1087",1087,"14-Mar-02",2002,"64","East",4,"Kentucky","SEC",83,13,"Valparaiso","Horz",68,"",-9,15,"4 over 13"
"1088",1088,"14-Mar-02",2002,"64","Midwest",8,"Stanford","P12",84,9,"Western Kentucky","CUSA",68,"",-1,16,"8 over 9"
"1089",1089,"14-Mar-02",2002,"64","South",1,"Duke","ACC",84,16,"Winthrop","BSth",37,"",-15,47,"1 over 16"
"1090",1090,"15-Mar-02",2002,"64","Midwest",6,"Texas","B12",70,11,"Boston College","ACC",57,"",-5,13,"6 over 11"
"1091",1091,"15-Mar-02",2002,"64","West",1,"Cincinnati","Amer",90,16,"Boston University","Pat",52,"",-15,38,"1 over 16"
"1092",1092,"15-Mar-02",2002,"64","South",3,"Pittsburgh","ACC",71,14,"Central Connecticut","NEC",54,"",-11,17,"3 over 14"
"1093",1093,"15-Mar-02",2002,"64","Midwest",12,"Creighton","BE",83,5,"Florida","SEC",82,"2 OT",7,1,"12 over 5"
"1094",1094,"15-Mar-02",2002,"64","East",2,"Connecticut","Amer",78,15,"Hampton","MEAC",67,"",-13,11,"2 over 15"
"1095",1095,"15-Mar-02",2002,"64","West",7,"Xavier","BE",70,10,"Hawaii","BW",58,"",-3,12,"7 over 10"
"1096",1096,"15-Mar-02",2002,"64","West",2,"Oklahoma","B12",71,15,"Illinois Chicago","Horz",63,"",-13,8,"2 over 15"
"1097",1097,"15-Mar-02",2002,"64","Midwest",3,"Mississippi St.","SEC",70,14,"McNeese St.","Slnd",58,"",-11,12,"3 over 14"
"1098",1098,"15-Mar-02",2002,"64","East",7,"North Carolina St.","ACC",69,10,"Michigan St.","B10",58,"",-3,11,"7 over 10"
"1099",1099,"15-Mar-02",2002,"64","West",8,"UCLA","P12",80,9,"Mississippi","SEC",58,"",-1,22,"8 over 9"
"1100",1100,"15-Mar-02",2002,"64","East",3,"Georgia","SEC",85,14,"Murray St.","OVC",68,"",-11,17,"3 over 14"
"1101",1101,"15-Mar-02",2002,"64","South",6,"California","P12",82,11,"Penn","Ivy",75,"",-5,7,"6 over 11"
"1102",1102,"15-Mar-02",2002,"64","Midwest",4,"Illinois","B10",93,13,"San Diego St.","MWC",64,"",-9,29,"4 over 13"
"1103",1103,"15-Mar-02",2002,"64","East",1,"Maryland","B10",85,16,"Siena","MAAC",70,"",-15,15,"1 over 16"
"1104",1104,"15-Mar-02",2002,"64","East",8,"Wisconsin","B10",80,9,"St. John's","BE",70,"",-1,10,"8 over 9"
"1105",1105,"15-Mar-02",2002,"64","East",11,"Southern Illinois","MVC",76,6,"Texas Tech","B12",68,"",5,8,"11 over 6"
"1106",1106,"16-Mar-02",2002,"32","South",10,"Kent St.","MAC",71,2,"Alabama","SEC",58,"",8,13,"10 over 2"
"1107",1107,"16-Mar-02",2002,"32","South",1,"Duke","ACC",84,8,"Notre Dame","ACC",77,"",-7,7,"1 over 8"
"1108",1108,"16-Mar-02",2002,"32","West",12,"Missouri","SEC",83,4,"Ohio St.","B10",67,"",8,16,"12 over 4"
"1109",1109,"16-Mar-02",2002,"32","Midwest",1,"Kansas","B12",86,8,"Stanford","P12",63,"",-7,23,"1 over 8"
"1110",1110,"16-Mar-02",2002,"32","East",4,"Kentucky","SEC",87,12,"Tulsa","Amer",82,"",-8,5,"4 over 12"
"1111",1111,"16-Mar-02",2002,"32","South",5,"Indiana","B10",76,13,"UNC Wilmington","CAA",67,"",-8,9,"5 over 13"
"1112",1112,"16-Mar-02",2002,"32","Midwest",2,"Oregon","P12",92,7,"Wake Forest","ACC",87,"",-5,5,"2 over 7"
"1113",1113,"16-Mar-02",2002,"32","West",3,"Arizona","P12",68,11,"Wyoming","MWC",60,"",-8,8,"3 over 11"
"1114",1114,"17-Mar-02",2002,"32","South",3,"Pittsburgh","ACC",63,6,"California","P12",50,"",-3,13,"3 over 6"
"1115",1115,"17-Mar-02",2002,"32","West",8,"UCLA","P12",105,1,"Cincinnati","Amer",101,"2 OT",7,4,"8 over 1"
"1116",1116,"17-Mar-02",2002,"32","Midwest",4,"Illinois","B10",72,12,"Creighton","BE",60,"",-8,12,"4 over 12"
"1117",1117,"17-Mar-02",2002,"32","East",11,"Southern Illinois","MVC",77,3,"Georgia","SEC",75,"",8,2,"11 over 3"
"1118",1118,"17-Mar-02",2002,"32","Midwest",6,"Texas","B12",68,3,"Mississippi St.","SEC",64,"",3,4,"6 over 3"
"1119",1119,"17-Mar-02",2002,"32","East",2,"Connecticut","Amer",77,7,"North Carolina St.","ACC",74,"",-5,3,"2 over 7"
"1120",1120,"17-Mar-02",2002,"32","East",1,"Maryland","B10",87,8,"Wisconsin","B10",57,"",-7,30,"1 over 8"
"1121",1121,"17-Mar-02",2002,"32","West",2,"Oklahoma","B12",78,7,"Xavier","BE",65,"",-5,13,"2 over 7"
"1122",1122,"21-Mar-02",2002,"16","West",2,"Oklahoma","B12",88,3,"Arizona","P12",67,"",-1,21,"2 over 3"
"1123",1123,"21-Mar-02",2002,"16","South",5,"Indiana","B10",74,1,"Duke","ACC",73,"",4,1,"5 over 1"
"1124",1124,"21-Mar-02",2002,"16","South",10,"Kent St.","MAC",78,3,"Pittsburgh","ACC",73,"",7,5,"10 over 3"
"1125",1125,"21-Mar-02",2002,"16","West",12,"Missouri","SEC",82,8,"UCLA","P12",73,"",4,9,"12 over 8"
"1126",1126,"22-Mar-02",2002,"16","Midwest",1,"Kansas","B12",73,4,"Illinois","B10",69,"",-3,4,"1 over 4"
"1127",1127,"22-Mar-02",2002,"16","East",1,"Maryland","B10",78,4,"Kentucky","SEC",68,"",-3,10,"1 over 4"
"1128",1128,"22-Mar-02",2002,"16","East",2,"Connecticut","Amer",71,11,"Southern Illinois","MVC",59,"",-9,12,"2 over 11"
"1129",1129,"22-Mar-02",2002,"16","Midwest",2,"Oregon","P12",72,6,"Texas","B12",70,"",-4,2,"2 over 6"
"1130",1130,"23-Mar-02",2002,"8","South",5,"Indiana","B10",81,10,"Kent St.","MAC",69,"",-5,12,"5 over 10"
"1131",1131,"23-Mar-02",2002,"8","West",2,"Oklahoma","B12",81,12,"Missouri","SEC",75,"",-10,6,"2 over 12"
"1132",1132,"24-Mar-02",2002,"8","East",1,"Maryland","B10",90,2,"Connecticut","Amer",82,"",-1,8,"1 over 2"
"1133",1133,"24-Mar-02",2002,"8","Midwest",1,"Kansas","B12",104,2,"Oregon","P12",86,"",-1,18,"1 over 2"
"1134",1134,"30-Mar-02",2002,"4","Final Four",1,"Maryland","B10",97,1,"Kansas","B12",88,"",0,9,"1 over 1"
"1135",1135,"30-Mar-02",2002,"4","Final Four",5,"Indiana","B10",73,2,"Oklahoma","B12",64,"",3,9,"5 over 2"
"1136",1136,"1-Apr-02",2002,"Champ","Championship",1,"Maryland","B10",64,5,"Indiana","B10",52,"",-4,12,"1 over 5"
"1137",1137,"18-Mar-03",2003,"Play-in","South",16,"UNC Asheville","BSth",92,16,"Texas Southern","SWAC",84,"1 OT",0,8,"16 over 16"
"1138",1138,"20-Mar-03",2003,"64","South",5,"Connecticut","Amer",58,12,"BYU","WCC",53,"",-7,5,"5 over 12"
"1139",1139,"20-Mar-03",2003,"64","West",9,"Gonzaga","WCC",74,8,"Cincinnati","Amer",69,"",1,5,"9 over 8"
"1140",1140,"20-Mar-03",2003,"64","West",3,"Duke","ACC",67,14,"Colorado St.","MWC",57,"",-11,10,"3 over 14"
"1141",1141,"20-Mar-03",2003,"64","West",11,"Central Michigan","MAC",79,6,"Creighton","BE",73,"",5,6,"11 over 6"
"1142",1142,"20-Mar-03",2003,"64","Midwest",13,"Tulsa","Amer",84,4,"Dayton","A10",71,"",9,13,"13 over 4"
"1143",1143,"20-Mar-03",2003,"64","Midwest",3,"Marquette","BE",72,14,"Holy Cross","Pat",68,"",-11,4,"3 over 14"
"1144",1144,"20-Mar-03",2003,"64","West",10,"Arizona St.","P12",84,7,"Memphis","Amer",71,"",3,13,"10 over 7"
"1145",1145,"20-Mar-03",2003,"64","West",5,"Notre Dame","ACC",70,12,"Milwaukee","Horz",69,"",-7,1,"5 over 12"
"1146",1146,"20-Mar-03",2003,"64","East",8,"California","P12",76,9,"North Carolina St.","ACC",74,"1 OT",-1,2,"8 over 9"
"1147",1147,"20-Mar-03",2003,"64","South",4,"Stanford","P12",77,13,"San Diego","WCC",69,"",-9,8,"4 over 13"
"1148",1148,"20-Mar-03",2003,"64","East",1,"Oklahoma","B12",71,16,"South Carolina St.","MEAC",54,"",-15,17,"1 over 16"
"1149",1149,"20-Mar-03",2003,"64","Midwest",6,"Missouri","SEC",72,11,"Southern Illinois","MVC",71,"",-5,1,"6 over 11"
"1150",1150,"20-Mar-03",2003,"64","West",2,"Kansas","B12",64,15,"Utah St.","MWC",61,"",-13,3,"2 over 15"
"1151",1151,"20-Mar-03",2003,"64","West",1,"Arizona","P12",80,16,"Vermont","AE",51,"",-15,29,"1 over 16"
"1152",1152,"20-Mar-03",2003,"64","Midwest",5,"Wisconsin","B10",81,12,"Weber St.","BSky",74,"",-7,7,"5 over 12"
"1153",1153,"20-Mar-03",2003,"64","West",4,"Illinois","B10",65,13,"Western Kentucky","CUSA",60,"",-9,5,"4 over 13"
"1154",1154,"21-Mar-03",2003,"64","Midwest",7,"Indiana","B10",67,10,"Alabama","SEC",62,"",-3,5,"7 over 10"
"1155",1155,"21-Mar-03",2003,"64","East",4,"Louisville","ACC",86,13,"Austin Peay","OVC",64,"",-9,22,"4 over 13"
"1156",1156,"21-Mar-03",2003,"64","South",7,"Michigan St.","B10",79,10,"Colorado","P12",64,"",-3,15,"7 over 10"
"1157",1157,"21-Mar-03",2003,"64","East",2,"Wake Forest","ACC",76,15,"East Tennessee St.","SC",73,"",-13,3,"2 over 15"
"1158",1158,"21-Mar-03",2003,"64","Midwest",1,"Kentucky","SEC",95,16,"IUPUI","Sum",64,"",-15,31,"1 over 16"
"1159",1159,"21-Mar-03",2003,"64","South",9,"Purdue","B10",80,8,"LSU","SEC",56,"",1,24,"9 over 8"
"1160",1160,"21-Mar-03",2003,"64","East",3,"Syracuse","ACC",76,14,"Manhattan","MAAC",65,"",-11,11,"3 over 14"
"1161",1161,"21-Mar-03",2003,"64","East",12,"Butler","BE",47,5,"Mississippi St.","SEC",46,"",7,1,"12 over 5"
"1162",1162,"21-Mar-03",2003,"64","Midwest",9,"Utah","P12",60,8,"Oregon","P12",58,"",1,2,"9 over 8"
"1163",1163,"21-Mar-03",2003,"64","East",6,"Oklahoma St.","B12",77,11,"Penn","Ivy",63,"",-5,14,"6 over 11"
"1164",1164,"21-Mar-03",2003,"64","East",10,"Auburn","SEC",65,7,"Saint Joseph's","A10",63,"1 OT",3,2,"10 over 7"
"1165",1165,"21-Mar-03",2003,"64","South",2,"Florida","SEC",85,15,"Sam Houston St.","Slnd",55,"",-13,30,"2 over 15"
"1166",1166,"21-Mar-03",2003,"64","South",3,"Xavier","BE",71,14,"Troy","SB",59,"",-11,12,"3 over 14"
"1167",1167,"21-Mar-03",2003,"64","South",1,"Texas","B12",82,16,"UNC Asheville","BSth",61,"",-15,21,"1 over 16"
"1168",1168,"21-Mar-03",2003,"64","South",6,"Maryland","B10",75,11,"UNC Wilmington","CAA",73,"",-5,2,"6 over 11"
"1169",1169,"21-Mar-03",2003,"64","Midwest",2,"Pittsburgh","ACC",87,15,"Wagner","NEC",61,"",-13,26,"2 over 15"
"1170",1170,"22-Mar-03",2003,"32","West",2,"Kansas","B12",108,10,"Arizona St.","P12",76,"",-8,32,"2 over 10"
"1171",1171,"22-Mar-03",2003,"32","East",1,"Oklahoma","B12",74,8,"California","P12",65,"",-7,9,"1 over 8"
"1172",1172,"22-Mar-03",2003,"32","West",3,"Duke","ACC",86,11,"Central Michigan","MAC",60,"",-8,26,"3 over 11"
"1173",1173,"22-Mar-03",2003,"32","West",1,"Arizona","P12",96,9,"Gonzaga","WCC",95,"2 OT",-8,1,"1 over 9"
"1174",1174,"22-Mar-03",2003,"32","West",5,"Notre Dame","ACC",68,4,"Illinois","B10",60,"",1,8,"5 over 4"
"1175",1175,"22-Mar-03",2003,"32","Midwest",3,"Marquette","BE",101,6,"Missouri","SEC",92,"1 OT",-3,9,"3 over 6"
"1176",1176,"22-Mar-03",2003,"32","South",5,"Connecticut","Amer",85,4,"Stanford","P12",74,"",1,11,"5 over 4"
"1177",1177,"22-Mar-03",2003,"32","Midwest",5,"Wisconsin","B10",61,13,"Tulsa","Amer",60,"",-8,1,"5 over 13"
"1178",1178,"23-Mar-03",2003,"32","South",7,"Michigan St.","B10",68,2,"Florida","SEC",46,"",5,22,"7 over 2"
"1179",1179,"23-Mar-03",2003,"32","Midwest",2,"Pittsburgh","ACC",74,7,"Indiana","B10",52,"",-5,22,"2 over 7"
"1180",1180,"23-Mar-03",2003,"32","East",12,"Butler","BE",79,4,"Louisville","ACC",71,"",8,8,"12 over 4"
"1181",1181,"23-Mar-03",2003,"32","East",3,"Syracuse","ACC",68,6,"Oklahoma St.","B12",56,"",-3,12,"3 over 6"
"1182",1182,"23-Mar-03",2003,"32","South",1,"Texas","B12",77,9,"Purdue","B10",67,"",-8,10,"1 over 9"
"1183",1183,"23-Mar-03",2003,"32","Midwest",1,"Kentucky","SEC",74,9,"Utah","P12",54,"",-8,20,"1 over 9"
"1184",1184,"23-Mar-03",2003,"32","East",10,"Auburn","SEC",68,2,"Wake Forest","ACC",62,"",8,6,"10 over 2"
"1185",1185,"23-Mar-03",2003,"32","South",6,"Maryland","B10",77,3,"Xavier","BE",64,"",3,13,"6 over 3"
"1186",1186,"27-Mar-03",2003,"16","West",2,"Kansas","B12",69,3,"Duke","ACC",65,"",-1,4,"2 over 3"
"1187",1187,"27-Mar-03",2003,"16","West",1,"Arizona","P12",88,5,"Notre Dame","ACC",71,"",-4,17,"1 over 5"
"1188",1188,"27-Mar-03",2003,"16","Midwest",3,"Marquette","BE",77,2,"Pittsburgh","ACC",74,"",1,3,"3 over 2"
"1189",1189,"27-Mar-03",2003,"16","Midwest",1,"Kentucky","SEC",63,5,"Wisconsin","B10",57,"",-4,6,"1 over 5"
"1190",1190,"28-Mar-03",2003,"16","East",3,"Syracuse","ACC",79,10,"Auburn","SEC",78,"",-7,1,"3 over 10"
"1191",1191,"28-Mar-03",2003,"16","East",1,"Oklahoma","B12",65,12,"Butler","BE",54,"",-11,11,"1 over 12"
"1192",1192,"28-Mar-03",2003,"16","South",1,"Texas","B12",82,5,"Connecticut","Amer",78,"",-4,4,"1 over 5"
"1193",1193,"28-Mar-03",2003,"16","South",7,"Michigan St.","B10",60,6,"Maryland","B10",58,"",1,2,"7 over 6"
"1194",1194,"29-Mar-03",2003,"8","West",2,"Kansas","B12",78,1,"Arizona","P12",75,"",1,3,"2 over 1"
"1195",1195,"29-Mar-03",2003,"8","Midwest",3,"Marquette","BE",83,1,"Kentucky","SEC",69,"",2,14,"3 over 1"
"1196",1196,"30-Mar-03",2003,"8","South",1,"Texas","B12",85,7,"Michigan St.","B10",76,"",-6,9,"1 over 7"
"1197",1197,"30-Mar-03",2003,"8","East",3,"Syracuse","ACC",63,1,"Oklahoma","B12",47,"",2,16,"3 over 1"
"1198",1198,"5-Apr-03",2003,"4","Final Four",2,"Kansas","B12",94,3,"Marquette","BE",61,"",-1,33,"2 over 3"
"1199",1199,"5-Apr-03",2003,"4","Final Four",3,"Syracuse","ACC",95,1,"Texas","B12",84,"",2,11,"3 over 1"
"1200",1200,"7-Apr-03",2003,"Champ","Championship",3,"Syracuse","ACC",81,2,"Kansas","B12",78,"",1,3,"3 over 2"
"1201",1201,"16-Mar-04",2004,"Play-in","Midwest",16,"Florida A&M","MEAC",72,16,"Lehigh","Pat",57,"",0,15,"16 over 16"
"1202",1202,"18-Mar-04",2004,"64","South",6,"North Carolina","ACC",63,11,"Air Force","MWC",52,"",-5,11,"6 over 11"
"1203",1203,"18-Mar-04",2004,"64","South",1,"Duke","ACC",96,16,"Alabama St.","SWAC",61,"",-15,35,"1 over 16"
"1204",1204,"18-Mar-04",2004,"64","South",8,"Seton Hall","BE",80,9,"Arizona","P12",76,"",-1,4,"8 over 9"
"1205",1205,"18-Mar-04",2004,"64","West",5,"Syracuse","ACC",80,12,"BYU","WCC",75,"",-7,5,"5 over 12"
"1206",1206,"18-Mar-04",2004,"64","East",8,"Texas Tech","B12",76,9,"Charlotte","CUSA",73,"",-1,3,"8 over 9"
"1207",1207,"18-Mar-04",2004,"64","West",7,"DePaul","BE",76,10,"Dayton","A10",69,"2 OT",-3,7,"7 over 10"
"1208",1208,"18-Mar-04",2004,"64","East",12,"Manhattan","MAAC",75,5,"Florida","SEC",60,"",7,15,"12 over 5"
"1209",1209,"18-Mar-04",2004,"64","East",1,"Saint Joseph's","A10",82,16,"Liberty","BSth",63,"",-15,19,"1 over 16"
"1210",1210,"18-Mar-04",2004,"64","Midwest",10,"Nevada","MWC",72,7,"Michigan St.","B10",66,"",3,6,"10 over 7"
"1211",1211,"18-Mar-04",2004,"64","South",3,"Texas","B12",66,14,"Princeton","Ivy",49,"",-11,17,"3 over 14"
"1212",1212,"18-Mar-04",2004,"64","West",8,"Alabama","SEC",65,9,"Southern Illinois","MVC",64,"",-1,1,"8 over 9"
"1213",1213,"18-Mar-04",2004,"64","West",4,"Maryland","B10",86,13,"UTEP","CUSA",83,"",-9,3,"4 over 13"
"1214",1214,"18-Mar-04",2004,"64","West",1,"Stanford","P12",71,16,"UTSA","CUSA",45,"",-15,26,"1 over 16"
"1215",1215,"18-Mar-04",2004,"64","Midwest",2,"Gonzaga","WCC",76,15,"Valparaiso","Horz",49,"",-13,27,"2 over 15"
"1216",1216,"18-Mar-04",2004,"64","East",4,"Wake Forest","ACC",79,13,"VCU","A10",78,"",-9,1,"4 over 13"
"1217",1217,"18-Mar-04",2004,"64","West",2,"Connecticut","Amer",70,15,"Vermont","AE",53,"",-13,17,"2 over 15"
"1218",1218,"19-Mar-04",2004,"64","South",4,"Cincinnati","Amer",80,13,"East Tennessee St.","SC",77,"",-9,3,"4 over 13"
"1219",1219,"19-Mar-04",2004,"64","East",2,"Oklahoma St.","B12",75,15,"Eastern Washington","BSky",56,"",-13,19,"2 over 15"
"1220",1220,"19-Mar-04",2004,"64","Midwest",1,"Kentucky","SEC",96,16,"Florida A&M","MEAC",76,"",-15,20,"1 over 16"
"1221",1221,"19-Mar-04",2004,"64","Midwest",4,"Kansas","B12",78,13,"Illinois Chicago","Horz",53,"",-9,25,"4 over 13"
"1222",1222,"19-Mar-04",2004,"64","West",3,"North Carolina St.","ACC",61,14,"Louisiana Lafayette","SB",52,"",-11,9,"3 over 14"
"1223",1223,"19-Mar-04",2004,"64","South",7,"Xavier","BE",80,10,"Louisville","ACC",70,"",-3,10,"7 over 10"
"1224",1224,"19-Mar-04",2004,"64","South",2,"Mississippi St.","SEC",85,15,"Monmouth","MAAC",52,"",-13,33,"2 over 15"
"1225",1225,"19-Mar-04",2004,"64","South",5,"Illinois","B10",72,12,"Murray St.","OVC",53,"",-7,19,"5 over 12"
"1226",1226,"19-Mar-04",2004,"64","Midwest",3,"Georgia Tech","ACC",65,14,"Northern Iowa","MVC",60,"",-11,5,"3 over 14"
"1227",1227,"19-Mar-04",2004,"64","Midwest",12,"Pacific","WCC",66,5,"Providence","BE",58,"",7,8,"12 over 5"
"1228",1228,"19-Mar-04",2004,"64","East",6,"Wisconsin","B10",76,11,"Richmond","A10",64,"",-5,12,"6 over 11"
"1229",1229,"19-Mar-04",2004,"64","East",7,"Memphis","Amer",59,10,"South Carolina","SEC",43,"",-3,16,"7 over 10"
"1230",1230,"19-Mar-04",2004,"64","East",3,"Pittsburgh","ACC",53,14,"UCF","Amer",44,"",-11,9,"3 over 14"
"1231",1231,"19-Mar-04",2004,"64","Midwest",6,"Boston College","ACC",58,11,"Utah","P12",51,"",-5,7,"6 over 11"
"1232",1232,"19-Mar-04",2004,"64","Midwest",9,"UAB","CUSA",102,8,"Washington","P12",100,"",1,2,"9 over 8"
"1233",1233,"19-Mar-04",2004,"64","West",6,"Vanderbilt","SEC",71,11,"Western Michigan","MAC",58,"",-5,13,"6 over 11"
"1234",1234,"20-Mar-04",2004,"32","West",2,"Connecticut","Amer",72,7,"DePaul","BE",55,"",-5,17,"2 over 7"
"1235",1235,"20-Mar-04",2004,"32","Midwest",10,"Nevada","MWC",91,2,"Gonzaga","WCC",72,"",8,19,"10 over 2"
"1236",1236,"20-Mar-04",2004,"32","East",4,"Wake Forest","ACC",84,12,"Manhattan","MAAC",80,"",-8,4,"4 over 12"
"1237",1237,"20-Mar-04",2004,"32","West",5,"Syracuse","ACC",72,4,"Maryland","B10",70,"",1,2,"5 over 4"
"1238",1238,"20-Mar-04",2004,"32","South",3,"Texas","B12",78,6,"North Carolina","ACC",75,"",-3,3,"3 over 6"
"1239",1239,"20-Mar-04",2004,"32","South",1,"Duke","ACC",90,8,"Seton Hall","BE",62,"",-7,28,"1 over 8"
"1240",1240,"20-Mar-04",2004,"32","West",8,"Alabama","SEC",70,1,"Stanford","P12",67,"",7,3,"8 over 1"
"1241",1241,"20-Mar-04",2004,"32","East",1,"Saint Joseph's","A10",70,8,"Texas Tech","B12",65,"",-7,5,"1 over 8"
"1242",1242,"21-Mar-04",2004,"32","Midwest",3,"Georgia Tech","ACC",57,6,"Boston College","ACC",54,"",-3,3,"3 over 6"
"1243",1243,"21-Mar-04",2004,"32","South",5,"Illinois","B10",92,4,"Cincinnati","Amer",68,"",1,24,"5 over 4"
"1244",1244,"21-Mar-04",2004,"32","Midwest",9,"UAB","CUSA",76,1,"Kentucky","SEC",75,"",8,1,"9 over 1"
"1245",1245,"21-Mar-04",2004,"32","East",2,"Oklahoma St.","B12",70,7,"Memphis","Amer",53,"",-5,17,"2 over 7"
"1246",1246,"21-Mar-04",2004,"32","South",7,"Xavier","BE",89,2,"Mississippi St.","SEC",74,"",5,15,"7 over 2"
"1247",1247,"21-Mar-04",2004,"32","West",6,"Vanderbilt","SEC",75,3,"North Carolina St.","ACC",73,"",3,2,"6 over 3"
"1248",1248,"21-Mar-04",2004,"32","Midwest",4,"Kansas","B12",78,12,"Pacific","WCC",63,"",-8,15,"4 over 12"
"1249",1249,"21-Mar-04",2004,"32","East",3,"Pittsburgh","ACC",59,6,"Wisconsin","B10",55,"",-3,4,"3 over 6"
"1250",1250,"25-Mar-04",2004,"16","East",2,"Oklahoma St.","B12",63,3,"Pittsburgh","ACC",51,"",-1,12,"2 over 3"
"1251",1251,"25-Mar-04",2004,"16","West",8,"Alabama","SEC",80,5,"Syracuse","ACC",71,"",3,9,"8 over 5"
"1252",1252,"25-Mar-04",2004,"16","West",2,"Connecticut","Amer",73,6,"Vanderbilt","SEC",53,"",-4,20,"2 over 6"
"1253",1253,"25-Mar-04",2004,"16","East",1,"Saint Joseph's","A10",84,4,"Wake Forest","ACC",80,"",-3,4,"1 over 4"
"1254",1254,"26-Mar-04",2004,"16","South",1,"Duke","ACC",72,5,"Illinois","B10",62,"",-4,10,"1 over 5"
"1255",1255,"26-Mar-04",2004,"16","Midwest",3,"Georgia Tech","ACC",72,10,"Nevada","MWC",67,"",-7,5,"3 over 10"
"1256",1256,"26-Mar-04",2004,"16","South",7,"Xavier","BE",79,3,"Texas","B12",71,"",4,8,"7 over 3"
"1257",1257,"26-Mar-04",2004,"16","Midwest",4,"Kansas","B12",100,9,"UAB","CUSA",74,"",-5,26,"4 over 9"
"1258",1258,"27-Mar-04",2004,"8","West",2,"Connecticut","Amer",87,8,"Alabama","SEC",71,"",-6,16,"2 over 8"
"1259",1259,"27-Mar-04",2004,"8","East",2,"Oklahoma St.","B12",64,1,"Saint Joseph's","A10",62,"",1,2,"2 over 1"
"1260",1260,"28-Mar-04",2004,"8","Midwest",3,"Georgia Tech","ACC",79,4,"Kansas","B12",71,"1 OT",-1,8,"3 over 4"
"1261",1261,"28-Mar-04",2004,"8","South",1,"Duke","ACC",66,7,"Xavier","BE",63,"",-6,3,"1 over 7"
"1262",1262,"3-Apr-04",2004,"4","Final Four",2,"Connecticut","Amer",79,1,"Duke","ACC",78,"",1,1,"2 over 1"
"1263",1263,"3-Apr-04",2004,"4","Final Four",3,"Georgia Tech","ACC",67,2,"Oklahoma St.","B12",65,"",1,2,"3 over 2"
"1264",1264,"5-Apr-04",2004,"Champ","Championship",2,"Connecticut","Amer",82,3,"Georgia Tech","ACC",73,"",-1,9,"2 over 3"
"1265",1265,"15-Mar-05",2005,"Play-in","East",16,"Oakland","Horz",79,16,"Alabama A&M","SWAC",69,"",0,10,"16 over 16"
"1266",1266,"17-Mar-05",2005,"64","Midwest",12,"Milwaukee","Horz",83,5,"Alabama","SEC",73,"",7,10,"12 over 5"
"1267",1267,"17-Mar-05",2005,"64","West",2,"Wake Forest","ACC",70,15,"Chattanooga","SC",54,"",-13,16,"2 over 15"
"1268",1268,"17-Mar-05",2005,"64","West",7,"West Virginia","B12",63,10,"Creighton","BE",61,"",-3,2,"7 over 10"
"1269",1269,"17-Mar-05",2005,"64","South",2,"Kentucky","SEC",72,15,"Eastern Kentucky","OVC",64,"",-13,8,"2 over 15"
"1270",1270,"17-Mar-05",2005,"64","Midwest",1,"Illinois","B10",67,16,"Fairleigh Dickinson","NEC",55,"",-15,12,"1 over 16"
"1271",1271,"17-Mar-05",2005,"64","South",7,"Cincinnati","Amer",76,10,"Iowa","B10",64,"",-3,12,"7 over 10"
"1272",1272,"17-Mar-05",2005,"64","Midwest",11,"UAB","CUSA",82,6,"LSU","SEC",68,"",5,14,"11 over 6"
"1273",1273,"17-Mar-05",2005,"64","West",1,"Washington","P12",88,16,"Montana","BSky",77,"",-15,11,"1 over 16"
"1274",1274,"17-Mar-05",2005,"64","South",3,"Oklahoma","B12",84,14,"Niagara","MAAC",67,"",-11,17,"3 over 14"
"1275",1275,"17-Mar-05",2005,"64","Midwest",4,"Boston College","ACC",85,13,"Penn","Ivy",65,"",-9,20,"4 over 13"
"1276",1276,"17-Mar-05",2005,"64","West",8,"Pacific","WCC",79,9,"Pittsburgh","ACC",71,"",-1,8,"8 over 9"
"1277",1277,"17-Mar-05",2005,"64","Midwest",9,"Nevada","MWC",61,8,"Texas","B12",57,"",1,4,"9 over 8"
"1278",1278,"17-Mar-05",2005,"64","West",6,"Texas Tech","B12",78,11,"UCLA","P12",66,"",-5,12,"6 over 11"
"1279",1279,"17-Mar-05",2005,"64","Midwest",3,"Arizona","P12",66,14,"Utah St.","MWC",53,"",-11,13,"3 over 14"
"1280",1280,"17-Mar-05",2005,"64","South",6,"Utah","P12",60,11,"UTEP","CUSA",54,"",-5,6,"6 over 11"
"1281",1281,"17-Mar-05",2005,"64","West",3,"Gonzaga","WCC",74,14,"Winthrop","BSth",64,"",-11,10,"3 over 14"
"1282",1282,"18-Mar-05",2005,"64","East",10,"North Carolina St.","ACC",75,7,"Charlotte","CUSA",63,"",3,12,"10 over 7"
"1283",1283,"18-Mar-05",2005,"64","South",1,"Duke","ACC",57,16,"Delaware St.","MEAC",46,"",-15,11,"1 over 16"
"1284",1284,"18-Mar-05",2005,"64","West",5,"Georgia Tech","ACC",80,12,"George Washington","A10",68,"",-7,12,"5 over 12"
"1285",1285,"18-Mar-05",2005,"64","East",14,"Bucknell","Pat",64,3,"Kansas","B12",63,"",11,1,"14 over 3"
"1286",1286,"18-Mar-05",2005,"64","West",4,"Louisville","ACC",68,13,"Louisiana Lafayette","SB",62,"",-9,6,"4 over 13"
"1287",1287,"18-Mar-05",2005,"64","East",9,"Iowa St.","B12",64,8,"Minnesota","B10",53,"",1,11,"9 over 8"
"1288",1288,"18-Mar-05",2005,"64","East",5,"Villanova","BE",55,12,"New Mexico","MWC",47,"",-7,8,"5 over 12"
"1289",1289,"18-Mar-05",2005,"64","East",6,"Wisconsin","B10",57,11,"Northern Iowa","MVC",52,"",-5,5,"6 over 11"
"1290",1290,"18-Mar-05",2005,"64","East",1,"North Carolina","ACC",96,16,"Oakland","Horz",68,"",-15,28,"1 over 16"
"1291",1291,"18-Mar-05",2005,"64","East",4,"Florida","SEC",67,13,"Ohio","MAC",62,"",-9,5,"4 over 13"
"1292",1292,"18-Mar-05",2005,"64","South",5,"Michigan St.","B10",89,12,"Old Dominion","CUSA",81,"",-7,8,"5 over 12"
"1293",1293,"18-Mar-05",2005,"64","Midwest",7,"Southern Illinois","MVC",65,10,"Saint Mary's","WCC",56,"",-3,9,"7 over 10"
"1294",1294,"18-Mar-05",2005,"64","Midwest",2,"Oklahoma St.","B12",63,15,"Southeastern Louisiana","Slnd",50,"",-13,13,"2 over 15"
"1295",1295,"18-Mar-05",2005,"64","South",9,"Mississippi St.","SEC",93,8,"Stanford","P12",70,"",1,23,"9 over 8"
"1296",1296,"18-Mar-05",2005,"64","South",13,"Vermont","AE",60,4,"Syracuse","ACC",57,"1 OT",9,3,"13 over 4"
"1297",1297,"18-Mar-05",2005,"64","East",2,"Connecticut","Amer",77,15,"UCF","Amer",71,"",-13,6,"2 over 15"
"1298",1298,"19-Mar-05",2005,"32","Midwest",12,"Milwaukee","Horz",83,4,"Boston College","ACC",75,"",8,8,"12 over 4"
"1299",1299,"19-Mar-05",2005,"32","South",2,"Kentucky","SEC",69,7,"Cincinnati","Amer",60,"",-5,9,"2 over 7"
"1300",1300,"19-Mar-05",2005,"32","West",6,"Texas Tech","B12",71,3,"Gonzaga","WCC",69,"",3,2,"6 over 3"
"1301",1301,"19-Mar-05",2005,"32","Midwest",1,"Illinois","B10",71,9,"Nevada","MWC",59,"",-8,12,"1 over 9"
"1302",1302,"19-Mar-05",2005,"32","South",6,"Utah","P12",67,3,"Oklahoma","B12",58,"",3,9,"6 over 3"
"1303",1303,"19-Mar-05",2005,"32","West",1,"Washington","P12",97,8,"Pacific","WCC",79,"",-7,18,"1 over 8"
"1304",1304,"19-Mar-05",2005,"32","Midwest",3,"Arizona","P12",85,11,"UAB","CUSA",63,"",-8,22,"3 over 11"
"1305",1305,"19-Mar-05",2005,"32","West",7,"West Virginia","B12",111,2,"Wake Forest","ACC",105,"2 OT",5,6,"7 over 2"
"1306",1306,"20-Mar-05",2005,"32","East",6,"Wisconsin","B10",71,14,"Bucknell","Pat",62,"",-8,9,"6 over 14"
"1307",1307,"20-Mar-05",2005,"32","East",10,"North Carolina St.","ACC",65,2,"Connecticut","Amer",62,"",8,3,"10 over 2"
"1308",1308,"20-Mar-05",2005,"32","East",5,"Villanova","BE",76,4,"Florida","SEC",65,"",1,11,"5 over 4"
"1309",1309,"20-Mar-05",2005,"32","West",4,"Louisville","ACC",76,5,"Georgia Tech","ACC",54,"",-1,22,"4 over 5"
"1310",1310,"20-Mar-05",2005,"32","East",1,"North Carolina","ACC",92,9,"Iowa St.","B12",65,"",-8,27,"1 over 9"
"1311",1311,"20-Mar-05",2005,"32","South",1,"Duke","ACC",63,9,"Mississippi St.","SEC",55,"",-8,8,"1 over 9"
"1312",1312,"20-Mar-05",2005,"32","Midwest",2,"Oklahoma St.","B12",85,7,"Southern Illinois","MVC",77,"",-5,8,"2 over 7"
"1313",1313,"20-Mar-05",2005,"32","South",5,"Michigan St.","B10",72,13,"Vermont","AE",61,"",-8,11,"5 over 13"
"1314",1314,"24-Mar-05",2005,"16","Midwest",1,"Illinois","B10",77,12,"Milwaukee","Horz",63,"",-11,14,"1 over 12"
"1315",1315,"24-Mar-05",2005,"16","Midwest",3,"Arizona","P12",79,2,"Oklahoma St.","B12",78,"",1,1,"3 over 2"
"1316",1316,"24-Mar-05",2005,"16","West",7,"West Virginia","B12",65,6,"Texas Tech","B12",60,"",1,5,"7 over 6"
"1317",1317,"24-Mar-05",2005,"16","West",4,"Louisville","ACC",93,1,"Washington","P12",79,"",3,14,"4 over 1"
"1318",1318,"25-Mar-05",2005,"16","South",5,"Michigan St.","B10",78,1,"Duke","ACC",68,"",4,10,"5 over 1"
"1319",1319,"25-Mar-05",2005,"16","East",6,"Wisconsin","B10",65,10,"North Carolina St.","ACC",56,"",-4,9,"6 over 10"
"1320",1320,"25-Mar-05",2005,"16","South",2,"Kentucky","SEC",62,6,"Utah","P12",52,"",-4,10,"2 over 6"
"1321",1321,"25-Mar-05",2005,"16","East",1,"North Carolina","ACC",67,5,"Villanova","BE",66,"",-4,1,"1 over 5"
"1322",1322,"26-Mar-05",2005,"8","Midwest",1,"Illinois","B10",90,3,"Arizona","P12",89,"1 OT",-2,1,"1 over 3"
"1323",1323,"26-Mar-05",2005,"8","West",4,"Louisville","ACC",93,7,"West Virginia","B12",85,"1 OT",-3,8,"4 over 7"
"1324",1324,"27-Mar-05",2005,"8","South",5,"Michigan St.","B10",94,2,"Kentucky","SEC",88,"2 OT",3,6,"5 over 2"
"1325",1325,"27-Mar-05",2005,"8","East",1,"North Carolina","ACC",88,6,"Wisconsin","B10",82,"",-5,6,"1 over 6"
"1326",1326,"2-Apr-05",2005,"4","Final Four",1,"Illinois","B10",72,4,"Louisville","ACC",57,"",-3,15,"1 over 4"
"1327",1327,"2-Apr-05",2005,"4","Final Four",1,"North Carolina","ACC",87,5,"Michigan St.","B10",71,"",-4,16,"1 over 5"
"1328",1328,"4-Apr-05",2005,"Champ","Championship",1,"North Carolina","ACC",75,1,"Illinois","B10",70,"",0,5,"1 over 1"
"1329",1329,"14-Mar-06",2006,"Play-in","Midwest",16,"Monmouth","MAAC",71,16,"Hampton","MEAC",49,"",0,22,"16 over 16"
"1330",1330,"16-Mar-06",2006,"64","East",4,"Illinois","B10",78,13,"Air Force","MWC",69,"",-9,9,"4 over 13"
"1331",1331,"16-Mar-06",2006,"64","West",2,"UCLA","P12",78,15,"Belmont","OVC",44,"",-13,34,"2 over 15"
"1332",1332,"16-Mar-06",2006,"64","South",4,"LSU","SEC",80,13,"Iona","MAAC",64,"",-9,16,"4 over 13"
"1333",1333,"16-Mar-06",2006,"64","West",10,"Alabama","SEC",90,7,"Marquette","BE",85,"",3,5,"10 over 7"
"1334",1334,"16-Mar-06",2006,"64","Midwest",12,"Montana","BSky",87,5,"Nevada","MWC",79,"",7,8,"12 over 5"
"1335",1335,"16-Mar-06",2006,"64","Midwest",11,"Milwaukee","Horz",82,6,"Oklahoma","B12",74,"",5,8,"11 over 6"
"1336",1336,"16-Mar-06",2006,"64","Midwest",4,"Boston College","ACC",88,13,"Pacific","WCC",76,"2 OT",-9,12,"4 over 13"
"1337",1337,"16-Mar-06",2006,"64","West",6,"Indiana","B10",87,11,"San Diego St.","MWC",83,"",-5,4,"6 over 11"
"1338",1338,"16-Mar-06",2006,"64","East",7,"Wichita St.","MVC",86,10,"Seton Hall","BE",66,"",-3,20,"7 over 10"
"1339",1339,"16-Mar-06",2006,"64","Midwest",3,"Florida","SEC",76,14,"South Alabama","SB",50,"",-11,26,"3 over 14"
"1340",1340,"16-Mar-06",2006,"64","South",1,"Duke","ACC",70,16,"Southern","SWAC",54,"",-15,16,"1 over 16"
"1341",1341,"16-Mar-06",2006,"64","South",12,"Texas A&M","SEC",66,5,"Syracuse","ACC",58,"",7,8,"12 over 5"
"1342",1342,"16-Mar-06",2006,"64","South",8,"George Washington","A10",88,9,"UNC Wilmington","CAA",85,"1 OT",-1,3,"8 over 9"
"1343",1343,"16-Mar-06",2006,"64","East",5,"Washington","P12",75,12,"Utah St.","MWC",61,"",-7,14,"5 over 12"
"1344",1344,"16-Mar-06",2006,"64","East",2,"Tennessee","SEC",63,15,"Winthrop","BSth",61,"",-13,2,"2 over 15"
"1345",1345,"16-Mar-06",2006,"64","West",3,"Gonzaga","WCC",79,14,"Xavier","BE",75,"",-11,4,"3 over 14"
"1346",1346,"17-Mar-06",2006,"64","East",1,"Connecticut","Amer",72,16,"Albany","AE",59,"",-15,13,"1 over 16"
"1347",1347,"17-Mar-06",2006,"64","West",9,"Bucknell","Pat",59,8,"Arkansas","SEC",55,"",1,4,"9 over 8"
"1348",1348,"17-Mar-06",2006,"64","South",10,"North Carolina St.","ACC",58,7,"California","P12",52,"",3,6,"10 over 7"
"1349",1349,"17-Mar-06",2006,"64","Midwest",2,"Ohio St.","B10",70,15,"Davidson","A10",62,"",-13,8,"2 over 15"
"1350",1350,"17-Mar-06",2006,"64","South",14,"Northwestern St.","Slnd",64,3,"Iowa","B10",63,"",11,1,"14 over 3"
"1351",1351,"17-Mar-06",2006,"64","West",13,"Bradley","MVC",77,4,"Kansas","B12",73,"",9,4,"13 over 4"
"1352",1352,"17-Mar-06",2006,"64","West",5,"Pittsburgh","ACC",79,12,"Kent St.","MAC",64,"",-7,15,"5 over 12"
"1353",1353,"17-Mar-06",2006,"64","East",11,"George Mason","A10",75,6,"Michigan St.","B10",65,"",5,10,"11 over 6"
"1354",1354,"17-Mar-06",2006,"64","Midwest",1,"Villanova","BE",58,16,"Monmouth","MAAC",45,"",-15,13,"1 over 16"
"1355",1355,"17-Mar-06",2006,"64","East",3,"North Carolina","ACC",69,14,"Murray St.","OVC",65,"",-11,4,"3 over 14"
"1356",1356,"17-Mar-06",2006,"64","Midwest",7,"Georgetown","BE",54,10,"Northern Iowa","MVC",49,"",-3,5,"7 over 10"
"1357",1357,"17-Mar-06",2006,"64","West",1,"Memphis","Amer",94,16,"Oral Roberts","Sum",78,"",-15,16,"1 over 16"
"1358",1358,"17-Mar-06",2006,"64","South",2,"Texas","B12",60,15,"Penn","Ivy",52,"",-13,8,"2 over 15"
"1359",1359,"17-Mar-06",2006,"64","South",6,"West Virginia","B12",64,11,"Southern Illinois","MVC",46,"",-5,18,"6 over 11"
"1360",1360,"17-Mar-06",2006,"64","East",8,"Kentucky","SEC",69,9,"UAB","CUSA",64,"",-1,5,"8 over 9"
"1361",1361,"17-Mar-06",2006,"64","Midwest",8,"Arizona","P12",94,9,"Wisconsin","B10",75,"",-1,19,"8 over 9"
"1362",1362,"18-Mar-06",2006,"32","West",2,"UCLA","P12",62,10,"Alabama","SEC",59,"",-8,3,"2 over 10"
"1363",1363,"18-Mar-06",2006,"32","South",1,"Duke","ACC",74,8,"George Washington","A10",61,"",-7,13,"1 over 8"
"1364",1364,"18-Mar-06",2006,"32","East",5,"Washington","P12",67,4,"Illinois","B10",64,"",1,3,"5 over 4"
"1365",1365,"18-Mar-06",2006,"32","West",3,"Gonzaga","WCC",90,6,"Indiana","B10",80,"",-3,10,"3 over 6"
"1366",1366,"18-Mar-06",2006,"32","Midwest",3,"Florida","SEC",82,11,"Milwaukee","Horz",60,"",-8,22,"3 over 11"
"1367",1367,"18-Mar-06",2006,"32","Midwest",4,"Boston College","ACC",69,12,"Montana","BSky",56,"",-8,13,"4 over 12"
"1368",1368,"18-Mar-06",2006,"32","East",7,"Wichita St.","MVC",80,2,"Tennessee","SEC",73,"",5,7,"7 over 2"
"1369",1369,"18-Mar-06",2006,"32","South",4,"LSU","SEC",58,12,"Texas A&M","SEC",57,"",-8,1,"4 over 12"
"1370",1370,"19-Mar-06",2006,"32","Midwest",1,"Villanova","BE",82,8,"Arizona","P12",78,"",-7,4,"1 over 8"
"1371",1371,"19-Mar-06",2006,"32","West",1,"Memphis","Amer",72,9,"Bucknell","Pat",56,"",-8,16,"1 over 9"
"1372",1372,"19-Mar-06",2006,"32","East",1,"Connecticut","Amer",87,8,"Kentucky","SEC",83,"",-7,4,"1 over 8"
"1373",1373,"19-Mar-06",2006,"32","East",11,"George Mason","A10",65,3,"North Carolina","ACC",60,"",8,5,"11 over 3"
"1374",1374,"19-Mar-06",2006,"32","South",2,"Texas","B12",75,10,"North Carolina St.","ACC",54,"",-8,21,"2 over 10"
"1375",1375,"19-Mar-06",2006,"32","South",6,"West Virginia","B12",67,14,"Northwestern St.","Slnd",54,"",-8,13,"6 over 14"
"1376",1376,"19-Mar-06",2006,"32","Midwest",7,"Georgetown","BE",70,2,"Ohio St.","B10",52,"",5,18,"7 over 2"
"1377",1377,"19-Mar-06",2006,"32","West",13,"Bradley","MVC",72,5,"Pittsburgh","ACC",66,"",8,6,"13 over 5"
"1378",1378,"23-Mar-06",2006,"16","West",1,"Memphis","Amer",80,13,"Bradley","MVC",64,"",-12,16,"1 over 13"
"1379",1379,"23-Mar-06",2006,"16","South",4,"LSU","SEC",62,1,"Duke","ACC",54,"",3,8,"4 over 1"
"1380",1380,"23-Mar-06",2006,"16","West",2,"UCLA","P12",73,3,"Gonzaga","WCC",71,"",-1,2,"2 over 3"
"1381",1381,"23-Mar-06",2006,"16","South",2,"Texas","B12",74,6,"West Virginia","B12",71,"",-4,3,"2 over 6"
"1382",1382,"24-Mar-06",2006,"16","Midwest",1,"Villanova","BE",60,4,"Boston College","ACC",59,"1 OT",-3,1,"1 over 4"
"1383",1383,"24-Mar-06",2006,"16","Midwest",3,"Florida","SEC",57,7,"Georgetown","BE",53,"",-4,4,"3 over 7"
"1384",1384,"24-Mar-06",2006,"16","East",1,"Connecticut","Amer",98,5,"Washington","P12",92,"1 OT",-4,6,"1 over 5"
"1385",1385,"24-Mar-06",2006,"16","East",11,"George Mason","A10",63,7,"Wichita St.","MVC",55,"",4,8,"11 over 7"
"1386",1386,"25-Mar-06",2006,"8","West",2,"UCLA","P12",50,1,"Memphis","Amer",45,"",1,5,"2 over 1"
"1387",1387,"25-Mar-06",2006,"8","South",4,"LSU","SEC",70,2,"Texas","B12",60,"1 OT",2,10,"4 over 2"
"1388",1388,"26-Mar-06",2006,"8","East",11,"George Mason","A10",86,1,"Connecticut","Amer",84,"1 OT",10,2,"11 over 1"
"1389",1389,"26-Mar-06",2006,"8","Midwest",3,"Florida","SEC",75,1,"Villanova","BE",62,"",2,13,"3 over 1"
"1390",1390,"1-Apr-06",2006,"4","Final Four",3,"Florida","SEC",73,11,"George Mason","A10",58,"",-8,15,"3 over 11"
"1391",1391,"1-Apr-06",2006,"4","Final Four",2,"UCLA","P12",59,4,"LSU","SEC",45,"",-2,14,"2 over 4"
"1392",1392,"3-Apr-06",2006,"Champ","Championship",3,"Florida","SEC",73,2,"UCLA","P12",57,"",1,16,"3 over 2"
"1393",1393,"13-Mar-07",2007,"Play-in","West",16,"Niagara","MAAC",77,16,"Florida A&M","MEAC",69,"",0,8,"16 over 16"
"1394",1394,"15-Mar-07",2007,"64","East",2,"Georgetown","BE",80,15,"Belmont","OVC",55,"",-13,25,"2 over 15"
"1395",1395,"15-Mar-07",2007,"64","South",9,"Xavier","BE",79,8,"BYU","WCC",77,"",1,2,"9 over 8"
"1396",1396,"15-Mar-07",2007,"64","South",1,"Ohio St.","B10",78,16,"Central Connecticut","NEC",57,"",-15,21,"1 over 16"
"1397",1397,"15-Mar-07",2007,"64","Midwest",4,"Maryland","B10",82,13,"Davidson","A10",70,"",-9,12,"4 over 13"
"1398",1398,"15-Mar-07",2007,"64","West",11,"VCU","A10",79,6,"Duke","ACC",77,"",5,2,"11 over 6"
"1399",1399,"15-Mar-07",2007,"64","East",1,"North Carolina","ACC",86,16,"Eastern Kentucky","OVC",65,"",-15,21,"1 over 16"
"1400",1400,"15-Mar-07",2007,"64","East",6,"Vanderbilt","SEC",77,11,"George Washington","A10",44,"",-5,33,"6 over 11"
"1401",1401,"15-Mar-07",2007,"64","West",7,"Indiana","B10",70,10,"Gonzaga","WCC",57,"",-3,13,"7 over 10"
"1402",1402,"15-Mar-07",2007,"64","East",9,"Michigan St.","B10",61,8,"Marquette","BE",49,"",1,12,"9 over 8"
"1403",1403,"15-Mar-07",2007,"64","Midwest",5,"Butler","BE",57,12,"Old Dominion","CUSA",46,"",-7,11,"5 over 12"
"1404",1404,"15-Mar-07",2007,"64","East",3,"Washington St.","P12",70,14,"Oral Roberts","Sum",54,"",-11,16,"3 over 14"
"1405",1405,"15-Mar-07",2007,"64","South",3,"Texas A&M","SEC",68,14,"Penn","Ivy",52,"",-11,16,"3 over 14"
"1406",1406,"15-Mar-07",2007,"64","South",6,"Louisville","ACC",78,11,"Stanford","P12",58,"",-5,20,"6 over 11"
"1407",1407,"15-Mar-07",2007,"64","East",7,"Boston College","ACC",84,10,"Texas Tech","B12",75,"",-3,9,"7 over 10"
"1408",1408,"15-Mar-07",2007,"64","West",2,"UCLA","P12",70,15,"Weber St.","BSky",42,"",-13,28,"2 over 15"
"1409",1409,"15-Mar-07",2007,"64","West",3,"Pittsburgh","ACC",79,14,"Wright St.","Horz",58,"",-11,21,"3 over 14"
"1410",1410,"16-Mar-07",2007,"64","South",4,"Virginia","ACC",84,13,"Albany","AE",57,"",-9,27,"4 over 13"
"1411",1411,"16-Mar-07",2007,"64","Midwest",9,"Purdue","B10",72,8,"Arizona","P12",63,"",1,9,"9 over 8"
"1412",1412,"16-Mar-07",2007,"64","East",5,"USC","P12",77,12,"Arkansas","SEC",60,"",-7,17,"5 over 12"
"1413",1413,"16-Mar-07",2007,"64","South",7,"Nevada","MWC",77,10,"Creighton","BE",71,"1 OT",-3,6,"7 over 10"
"1414",1414,"16-Mar-07",2007,"64","Midwest",7,"UNLV","MWC",67,10,"Georgia Tech","ACC",63,"",-3,4,"7 over 10"
"1415",1415,"16-Mar-07",2007,"64","West",4,"Southern Illinois","MVC",61,13,"Holy Cross","Pat",51,"",-9,10,"4 over 13"
"1416",1416,"16-Mar-07",2007,"64","West",5,"Virginia Tech","ACC",54,12,"Illinois","B10",52,"",-7,2,"5 over 12"
"1417",1417,"16-Mar-07",2007,"64","Midwest",1,"Florida","SEC",112,16,"Jackson St.","SWAC",69,"",-15,43,"1 over 16"
"1418",1418,"16-Mar-07",2007,"64","South",5,"Tennessee","SEC",121,12,"Long Beach St.","BW",86,"",-7,35,"5 over 12"
"1419",1419,"16-Mar-07",2007,"64","Midwest",3,"Oregon","P12",58,14,"Miami OH","MAC",56,"",-11,2,"3 over 14"
"1420",1420,"16-Mar-07",2007,"64","East",4,"Texas","B12",79,13,"New Mexico St.","WAC",67,"",-9,12,"4 over 13"
"1421",1421,"16-Mar-07",2007,"64","West",1,"Kansas","B12",107,16,"Niagara","MAAC",67,"",-15,40,"1 over 16"
"1422",1422,"16-Mar-07",2007,"64","South",2,"Memphis","Amer",73,15,"North Texas","CUSA",58,"",-13,15,"2 over 15"
"1423",1423,"16-Mar-07",2007,"64","Midwest",11,"Winthrop","BSth",74,6,"Notre Dame","ACC",64,"",5,10,"11 over 6"
"1424",1424,"16-Mar-07",2007,"64","Midwest",2,"Wisconsin","B10",76,15,"Texas A&M Corpus Christi",NA,63,"",-13,13,"2 over 15"
"1425",1425,"16-Mar-07",2007,"64","West",8,"Kentucky","SEC",67,9,"Villanova","BE",58,"",-1,9,"8 over 9"
"1426",1426,"17-Mar-07",2007,"32","East",2,"Georgetown","BE",62,7,"Boston College","ACC",55,"",-5,7,"2 over 7"
"1427",1427,"17-Mar-07",2007,"32","West",2,"UCLA","P12",54,7,"Indiana","B10",49,"",-5,5,"2 over 7"
"1428",1428,"17-Mar-07",2007,"32","South",3,"Texas A&M","SEC",72,6,"Louisville","ACC",69,"",-3,3,"3 over 6"
"1429",1429,"17-Mar-07",2007,"32","Midwest",5,"Butler","BE",62,4,"Maryland","B10",59,"",1,3,"5 over 4"
"1430",1430,"17-Mar-07",2007,"32","East",1,"North Carolina","ACC",81,9,"Michigan St.","B10",67,"",-8,14,"1 over 9"
"1431",1431,"17-Mar-07",2007,"32","West",3,"Pittsburgh","ACC",84,11,"VCU","A10",79,"1 OT",-8,5,"3 over 11"
"1432",1432,"17-Mar-07",2007,"32","East",6,"Vanderbilt","SEC",78,3,"Washington St.","P12",74,"2 OT",3,4,"6 over 3"
"1433",1433,"17-Mar-07",2007,"32","South",1,"Ohio St.","B10",78,9,"Xavier","BE",71,"1 OT",-8,7,"1 over 9"
"1434",1434,"18-Mar-07",2007,"32","West",1,"Kansas","B12",88,8,"Kentucky","SEC",76,"",-7,12,"1 over 8"
"1435",1435,"18-Mar-07",2007,"32","South",2,"Memphis","Amer",78,7,"Nevada","MWC",62,"",-5,16,"2 over 7"
"1436",1436,"18-Mar-07",2007,"32","Midwest",1,"Florida","SEC",74,9,"Purdue","B10",67,"",-8,7,"1 over 9"
"1437",1437,"18-Mar-07",2007,"32","East",5,"USC","P12",87,4,"Texas","B12",68,"",1,19,"5 over 4"
"1438",1438,"18-Mar-07",2007,"32","South",5,"Tennessee","SEC",77,4,"Virginia","ACC",74,"",1,3,"5 over 4"
"1439",1439,"18-Mar-07",2007,"32","West",4,"Southern Illinois","MVC",63,5,"Virginia Tech","ACC",48,"",-1,15,"4 over 5"
"1440",1440,"18-Mar-07",2007,"32","Midwest",3,"Oregon","P12",75,11,"Winthrop","BSth",61,"",-8,14,"3 over 11"
"1441",1441,"18-Mar-07",2007,"32","Midwest",7,"UNLV","MWC",74,2,"Wisconsin","B10",68,"",5,6,"7 over 2"
"1442",1442,"22-Mar-07",2007,"16","West",2,"UCLA","P12",64,3,"Pittsburgh","ACC",55,"",-1,9,"2 over 3"
"1443",1443,"22-Mar-07",2007,"16","West",1,"Kansas","B12",61,4,"Southern Illinois","MVC",58,"",-3,3,"1 over 4"
"1444",1444,"22-Mar-07",2007,"16","South",1,"Ohio St.","B10",85,5,"Tennessee","SEC",84,"",-4,1,"1 over 5"
"1445",1445,"22-Mar-07",2007,"16","South",2,"Memphis","Amer",65,3,"Texas A&M","SEC",64,"",-1,1,"2 over 3"
"1446",1446,"23-Mar-07",2007,"16","Midwest",1,"Florida","SEC",65,5,"Butler","BE",57,"",-4,8,"1 over 5"
"1447",1447,"23-Mar-07",2007,"16","Midwest",3,"Oregon","P12",76,7,"UNLV","MWC",72,"",-4,4,"3 over 7"
"1448",1448,"23-Mar-07",2007,"16","East",1,"North Carolina","ACC",74,5,"USC","P12",64,"",-4,10,"1 over 5"
"1449",1449,"23-Mar-07",2007,"16","East",2,"Georgetown","BE",66,6,"Vanderbilt","SEC",65,"",-4,1,"2 over 6"
"1450",1450,"24-Mar-07",2007,"8","West",2,"UCLA","P12",68,1,"Kansas","B12",55,"",1,13,"2 over 1"
"1451",1451,"24-Mar-07",2007,"8","South",1,"Ohio St.","B10",92,2,"Memphis","Amer",76,"",-1,16,"1 over 2"
"1452",1452,"25-Mar-07",2007,"8","East",2,"Georgetown","BE",96,1,"North Carolina","ACC",84,"1 OT",1,12,"2 over 1"
"1453",1453,"25-Mar-07",2007,"8","Midwest",1,"Florida","SEC",85,3,"Oregon","P12",77,"",-2,8,"1 over 3"
"1454",1454,"31-Mar-07",2007,"4","Final Four",1,"Ohio St.","B10",67,2,"Georgetown","BE",60,"",-1,7,"1 over 2"
"1455",1455,"31-Mar-07",2007,"4","Final Four",1,"Florida","SEC",76,2,"UCLA","P12",66,"",-1,10,"1 over 2"
"1456",1456,"2-Apr-07",2007,"Champ","Championship",1,"Florida","SEC",84,1,"Ohio St.","B10",75,"",0,9,"1 over 1"
"1457",1457,"18-Mar-08",2008,"Play-in","East",16,"Mount St. Mary's","NEC",69,16,"Coppin St.","MEAC",60,"",0,9,"16 over 16"
"1458",1458,"20-Mar-08",2008,"64","West",7,"West Virginia","B12",75,10,"Arizona","P12",65,"",-3,10,"7 over 10"
"1459",1459,"20-Mar-08",2008,"64","West",6,"Purdue","B10",90,11,"Baylor","B12",79,"",-5,11,"6 over 11"
"1460",1460,"20-Mar-08",2008,"64","West",2,"Duke","ACC",71,15,"Belmont","OVC",70,"",-13,1,"2 over 15"
"1461",1461,"20-Mar-08",2008,"64","West",9,"Texas A&M","SEC",67,8,"BYU","WCC",62,"",1,5,"9 over 8"
"1462",1462,"20-Mar-08",2008,"64","Midwest",3,"Wisconsin","B10",71,14,"Cal St. Fullerton","BW",56,"",-11,15,"3 over 14"
"1463",1463,"20-Mar-08",2008,"64","South",3,"Stanford","P12",77,14,"Cornell","Ivy",53,"",-11,24,"3 over 14"
"1464",1464,"20-Mar-08",2008,"64","East",5,"Notre Dame","ACC",68,12,"George Mason","A10",50,"",-7,18,"5 over 12"
"1465",1465,"20-Mar-08",2008,"64","West",3,"Xavier","BE",73,14,"Georgia","SEC",61,"",-11,12,"3 over 14"
"1466",1466,"20-Mar-08",2008,"64","Midwest",8,"UNLV","MWC",71,9,"Kent St.","MAC",58,"",-1,13,"8 over 9"
"1467",1467,"20-Mar-08",2008,"64","South",6,"Marquette","BE",74,11,"Kentucky","SEC",66,"",-5,8,"6 over 11"
"1468",1468,"20-Mar-08",2008,"64","West",1,"UCLA","P12",70,16,"Mississippi Valley",NA,29,"",-15,41,"1 over 16"
"1469",1469,"20-Mar-08",2008,"64","South",4,"Pittsburgh","ACC",82,13,"Oral Roberts","Sum",63,"",-9,19,"4 over 13"
"1470",1470,"20-Mar-08",2008,"64","Midwest",1,"Kansas","B12",85,16,"Portland St.","BSky",61,"",-15,24,"1 over 16"
"1471",1471,"20-Mar-08",2008,"64","South",5,"Michigan St.","B10",72,12,"Temple","Amer",61,"",-7,11,"5 over 12"
"1472",1472,"20-Mar-08",2008,"64","Midwest",11,"Kansas St.","B12",80,6,"USC","P12",67,"",5,13,"11 over 6"
"1473",1473,"20-Mar-08",2008,"64","East",4,"Washington St.","P12",71,13,"Winthrop","BSth",40,"",-9,31,"4 over 13"
"1474",1474,"21-Mar-08",2008,"64","East",2,"Tennessee","SEC",72,15,"American","Pat",57,"",-13,15,"2 over 15"
"1475",1475,"21-Mar-08",2008,"64","South",2,"Texas","B12",74,15,"Austin Peay","OVC",54,"",-13,20,"2 over 15"
"1476",1476,"21-Mar-08",2008,"64","East",3,"Louisville","ACC",79,14,"Boise St.","MWC",61,"",-11,18,"3 over 14"
"1477",1477,"21-Mar-08",2008,"64","Midwest",12,"Villanova","BE",75,5,"Clemson","ACC",69,"",7,6,"12 over 5"
"1478",1478,"21-Mar-08",2008,"64","West",13,"San Diego","WCC",70,4,"Connecticut","Amer",69,"1 OT",9,1,"13 over 4"
"1479",1479,"21-Mar-08",2008,"64","West",12,"Western Kentucky","CUSA",101,5,"Drake","MVC",99,"1 OT",7,2,"12 over 5"
"1480",1480,"21-Mar-08",2008,"64","Midwest",10,"Davidson","A10",82,7,"Gonzaga","WCC",76,"",3,6,"10 over 7"
"1481",1481,"21-Mar-08",2008,"64","East",9,"Arkansas","SEC",86,8,"Indiana","B10",72,"",1,14,"9 over 8"
"1482",1482,"21-Mar-08",2008,"64","East",1,"North Carolina","ACC",113,16,"Mount St. Mary's","NEC",74,"",-15,39,"1 over 16"
"1483",1483,"21-Mar-08",2008,"64","South",8,"Mississippi St.","SEC",76,9,"Oregon","P12",69,"",-1,7,"8 over 9"
"1484",1484,"21-Mar-08",2008,"64","East",6,"Oklahoma","B12",72,11,"Saint Joseph's","A10",64,"",-5,8,"6 over 11"
"1485",1485,"21-Mar-08",2008,"64","South",7,"Miami FL","ACC",78,10,"Saint Mary's","WCC",64,"",-3,14,"7 over 10"
"1486",1486,"21-Mar-08",2008,"64","East",7,"Butler","BE",81,10,"South Alabama","SB",61,"",-3,20,"7 over 10"
"1487",1487,"21-Mar-08",2008,"64","South",1,"Memphis","Amer",87,16,"Texas Arlington",NA,63,"",-15,24,"1 over 16"
"1488",1488,"21-Mar-08",2008,"64","Midwest",2,"Georgetown","BE",66,15,"UMBC","AE",47,"",-13,19,"2 over 15"
"1489",1489,"21-Mar-08",2008,"64","Midwest",13,"Siena","MAAC",83,4,"Vanderbilt","SEC",62,"",9,21,"13 over 4"
"1490",1490,"22-Mar-08",2008,"32","West",7,"West Virginia","B12",73,2,"Duke","ACC",67,"",5,6,"7 over 2"
"1491",1491,"22-Mar-08",2008,"32","Midwest",3,"Wisconsin","B10",72,11,"Kansas St.","B12",55,"",-8,17,"3 over 11"
"1492",1492,"22-Mar-08",2008,"32","South",3,"Stanford","P12",82,6,"Marquette","BE",81,"1 OT",-3,1,"3 over 6"
"1493",1493,"22-Mar-08",2008,"32","East",4,"Washington St.","P12",61,5,"Notre Dame","ACC",41,"",-1,20,"4 over 5"
"1494",1494,"22-Mar-08",2008,"32","South",5,"Michigan St.","B10",65,4,"Pittsburgh","ACC",54,"",1,11,"5 over 4"
"1495",1495,"22-Mar-08",2008,"32","West",3,"Xavier","BE",85,6,"Purdue","B10",78,"",-3,7,"3 over 6"
"1496",1496,"22-Mar-08",2008,"32","West",1,"UCLA","P12",53,9,"Texas A&M","SEC",49,"",-8,4,"1 over 9"
"1497",1497,"22-Mar-08",2008,"32","Midwest",1,"Kansas","B12",75,8,"UNLV","MWC",56,"",-7,19,"1 over 8"
"1498",1498,"23-Mar-08",2008,"32","East",1,"North Carolina","ACC",108,9,"Arkansas","SEC",77,"",-8,31,"1 over 9"
"1499",1499,"23-Mar-08",2008,"32","East",2,"Tennessee","SEC",76,7,"Butler","BE",71,"1 OT",-5,5,"2 over 7"
"1500",1500,"23-Mar-08",2008,"32","Midwest",10,"Davidson","A10",74,2,"Georgetown","BE",70,"",8,4,"10 over 2"
"1501",1501,"23-Mar-08",2008,"32","South",2,"Texas","B12",75,7,"Miami FL","ACC",72,"",-5,3,"2 over 7"
"1502",1502,"23-Mar-08",2008,"32","South",1,"Memphis","Amer",77,8,"Mississippi St.","SEC",74,"",-7,3,"1 over 8"
"1503",1503,"23-Mar-08",2008,"32","East",3,"Louisville","ACC",78,6,"Oklahoma","B12",48,"",-3,30,"3 over 6"
"1504",1504,"23-Mar-08",2008,"32","West",12,"Western Kentucky","CUSA",72,13,"San Diego","WCC",63,"",-1,9,"12 over 13"
"1505",1505,"23-Mar-08",2008,"32","Midwest",12,"Villanova","BE",84,13,"Siena","MAAC",72,"",-1,12,"12 over 13"
"1506",1506,"27-Mar-08",2008,"16","East",3,"Louisville","ACC",79,2,"Tennessee","SEC",60,"",1,19,"3 over 2"
"1507",1507,"27-Mar-08",2008,"16","East",1,"North Carolina","ACC",68,4,"Washington St.","P12",47,"",-3,21,"1 over 4"
"1508",1508,"27-Mar-08",2008,"16","West",3,"Xavier","BE",79,7,"West Virginia","B12",75,"1 OT",-4,4,"3 over 7"
"1509",1509,"27-Mar-08",2008,"16","West",1,"UCLA","P12",88,12,"Western Kentucky","CUSA",78,"",-11,10,"1 over 12"
"1510",1510,"28-Mar-08",2008,"16","South",1,"Memphis","Amer",92,5,"Michigan St.","B10",74,"",-4,18,"1 over 5"
"1511",1511,"28-Mar-08",2008,"16","South",2,"Texas","B12",82,3,"Stanford","P12",62,"",-1,20,"2 over 3"
"1512",1512,"28-Mar-08",2008,"16","Midwest",1,"Kansas","B12",72,12,"Villanova","BE",57,"",-11,15,"1 over 12"
"1513",1513,"28-Mar-08",2008,"16","Midwest",10,"Davidson","A10",73,3,"Wisconsin","B10",56,"",7,17,"10 over 3"
"1514",1514,"29-Mar-08",2008,"8","East",1,"North Carolina","ACC",83,3,"Louisville","ACC",73,"",-2,10,"1 over 3"
"1515",1515,"29-Mar-08",2008,"8","West",1,"UCLA","P12",76,3,"Xavier","BE",57,"",-2,19,"1 over 3"
"1516",1516,"30-Mar-08",2008,"8","Midwest",1,"Kansas","B12",59,10,"Davidson","A10",57,"",-9,2,"1 over 10"
"1517",1517,"30-Mar-08",2008,"8","South",1,"Memphis","Amer",85,2,"Texas","B12",67,"",-1,18,"1 over 2"
"1518",1518,"5-Apr-08",2008,"4","Final Four",1,"Kansas","B12",84,1,"North Carolina","ACC",66,"",0,18,"1 over 1"
"1519",1519,"5-Apr-08",2008,"4","Final Four",1,"Memphis","Amer",78,1,"UCLA","P12",63,"",0,15,"1 over 1"
"1520",1520,"7-Apr-08",2008,"Champ","Championship",1,"Kansas","B12",75,1,"Memphis","Amer",68,"1 OT",0,7,"1 over 1"
"1521",1521,"17-Mar-09",2009,"Play-in","Midwest",16,"Morehead St.","OVC",58,16,"Alabama St.","SWAC",43,"",0,15,"16 over 16"
"1522",1522,"19-Mar-09",2009,"64","South",4,"Gonzaga","WCC",77,13,"Akron","MAC",64,"",-9,13,"4 over 13"
"1523",1523,"19-Mar-09",2009,"64","East",3,"Villanova","BE",80,14,"American","Pat",67,"",-11,13,"3 over 14"
"1524",1524,"19-Mar-09",2009,"64","East",2,"Duke","ACC",86,15,"Binghamton","AE",62,"",-13,24,"2 over 15"
"1525",1525,"19-Mar-09",2009,"64","South",8,"LSU","SEC",75,9,"Butler","BE",71,"",-1,4,"8 over 9"
"1526",1526,"19-Mar-09",2009,"64","West",9,"Texas A&M","SEC",79,8,"BYU","WCC",66,"",1,13,"9 over 8"
"1527",1527,"19-Mar-09",2009,"64","West",2,"Memphis","Amer",81,15,"Cal St. Northridge","BW",70,"",-13,11,"2 over 15"
"1528",1528,"19-Mar-09",2009,"64","West",10,"Maryland","B10",84,7,"California","P12",71,"",3,13,"10 over 7"
"1529",1529,"19-Mar-09",2009,"64","West",1,"Connecticut","Amer",103,16,"Chattanooga","SC",47,"",-15,56,"1 over 16"
"1530",1530,"19-Mar-09",2009,"64","South",10,"Michigan","B10",62,7,"Clemson","ACC",59,"",3,3,"10 over 7"
"1531",1531,"19-Mar-09",2009,"64","South",12,"Western Kentucky","CUSA",76,5,"Illinois","B10",72,"",7,4,"12 over 5"
"1532",1532,"19-Mar-09",2009,"64","East",7,"Texas","B12",76,10,"Minnesota","B10",62,"",-3,14,"7 over 10"
"1533",1533,"19-Mar-09",2009,"64","West",4,"Washington","P12",71,13,"Mississippi St.","SEC",58,"",-9,13,"4 over 13"
"1534",1534,"19-Mar-09",2009,"64","South",2,"Oklahoma","B12",82,15,"Morgan St.","MEAC",54,"",-13,28,"2 over 15"
"1535",1535,"19-Mar-09",2009,"64","West",5,"Purdue","B10",61,12,"Northern Iowa","MVC",56,"",-7,5,"5 over 12"
"1536",1536,"19-Mar-09",2009,"64","South",1,"North Carolina","ACC",101,16,"Radford","BSth",58,"",-15,43,"1 over 16"
"1537",1537,"19-Mar-09",2009,"64","East",6,"UCLA","P12",65,11,"VCU","A10",64,"",-5,1,"6 over 11"
"1538",1538,"20-Mar-09",2009,"64","Midwest",10,"USC","P12",72,7,"Boston College","ACC",55,"",3,17,"10 over 7"
"1539",1539,"20-Mar-09",2009,"64","West",3,"Missouri","SEC",78,14,"Cornell","Ivy",59,"",-11,19,"3 over 14"
"1540",1540,"20-Mar-09",2009,"64","East",1,"Pittsburgh","ACC",72,16,"East Tennessee St.","SC",62,"",-15,10,"1 over 16"
"1541",1541,"20-Mar-09",2009,"64","East",12,"Wisconsin","B10",61,5,"Florida St.","ACC",59,"1 OT",7,2,"12 over 5"
"1542",1542,"20-Mar-09",2009,"64","Midwest",1,"Louisville","ACC",74,16,"Morehead St.","OVC",54,"",-15,20,"1 over 16"
"1543",1543,"20-Mar-09",2009,"64","Midwest",3,"Kansas","B12",84,14,"North Dakota St.","Sum",74,"",-11,10,"3 over 14"
"1544",1544,"20-Mar-09",2009,"64","Midwest",9,"Siena","MAAC",74,8,"Ohio St.","B10",72,"2 OT",1,2,"9 over 8"
"1545",1545,"20-Mar-09",2009,"64","East",4,"Xavier","BE",77,13,"Portland St.","BSky",59,"",-9,18,"4 over 13"
"1546",1546,"20-Mar-09",2009,"64","Midwest",2,"Michigan St.","B10",77,15,"Robert Morris","NEC",62,"",-13,15,"2 over 15"
"1547",1547,"20-Mar-09",2009,"64","South",3,"Syracuse","ACC",59,14,"Stephen F. Austin","Slnd",44,"",-11,15,"3 over 14"
"1548",1548,"20-Mar-09",2009,"64","South",6,"Arizona St.","P12",66,11,"Temple","Amer",57,"",-5,9,"6 over 11"
"1549",1549,"20-Mar-09",2009,"64","East",8,"Oklahoma St.","B12",77,9,"Tennessee","SEC",75,"",-1,2,"8 over 9"
"1550",1550,"20-Mar-09",2009,"64","Midwest",12,"Arizona","P12",84,5,"Utah","P12",71,"",7,13,"12 over 5"
"1551",1551,"20-Mar-09",2009,"64","West",6,"Marquette","BE",58,11,"Utah St.","MWC",57,"",-5,1,"6 over 11"
"1552",1552,"20-Mar-09",2009,"64","Midwest",13,"Cleveland St.","Horz",84,4,"Wake Forest","ACC",69,"",9,15,"13 over 4"
"1553",1553,"20-Mar-09",2009,"64","Midwest",11,"Dayton","A10",68,6,"West Virginia","B12",60,"",5,8,"11 over 6"
"1554",1554,"21-Mar-09",2009,"32","South",1,"North Carolina","ACC",84,8,"LSU","SEC",70,"",-7,14,"1 over 8"
"1555",1555,"21-Mar-09",2009,"32","West",2,"Memphis","Amer",89,10,"Maryland","B10",70,"",-8,19,"2 over 10"
"1556",1556,"21-Mar-09",2009,"32","South",2,"Oklahoma","B12",73,10,"Michigan","B10",63,"",-8,10,"2 over 10"
"1557",1557,"21-Mar-09",2009,"32","East",2,"Duke","ACC",74,7,"Texas","B12",69,"",-5,5,"2 over 7"
"1558",1558,"21-Mar-09",2009,"32","West",1,"Connecticut","Amer",92,9,"Texas A&M","SEC",66,"",-8,26,"1 over 9"
"1559",1559,"21-Mar-09",2009,"32","East",3,"Villanova","BE",89,6,"UCLA","P12",69,"",-3,20,"3 over 6"
"1560",1560,"21-Mar-09",2009,"32","West",5,"Purdue","B10",76,4,"Washington","P12",74,"",1,2,"5 over 4"
"1561",1561,"21-Mar-09",2009,"32","South",4,"Gonzaga","WCC",83,12,"Western Kentucky","CUSA",81,"",-8,2,"4 over 12"
"1562",1562,"22-Mar-09",2009,"32","South",3,"Syracuse","ACC",78,6,"Arizona St.","P12",67,"",-3,11,"3 over 6"
"1563",1563,"22-Mar-09",2009,"32","Midwest",12,"Arizona","P12",71,13,"Cleveland St.","Horz",57,"",-1,14,"12 over 13"
"1564",1564,"22-Mar-09",2009,"32","Midwest",3,"Kansas","B12",60,11,"Dayton","A10",43,"",-8,17,"3 over 11"
"1565",1565,"22-Mar-09",2009,"32","West",3,"Missouri","SEC",83,6,"Marquette","BE",79,"",-3,4,"3 over 6"
"1566",1566,"22-Mar-09",2009,"32","East",1,"Pittsburgh","ACC",84,8,"Oklahoma St.","B12",76,"",-7,8,"1 over 8"
"1567",1567,"22-Mar-09",2009,"32","Midwest",1,"Louisville","ACC",79,9,"Siena","MAAC",72,"",-8,7,"1 over 9"
"1568",1568,"22-Mar-09",2009,"32","Midwest",2,"Michigan St.","B10",74,10,"USC","P12",69,"",-8,5,"2 over 10"
"1569",1569,"22-Mar-09",2009,"32","East",4,"Xavier","BE",60,12,"Wisconsin","B10",49,"",-8,11,"4 over 12"
"1570",1570,"26-Mar-09",2009,"16","East",3,"Villanova","BE",77,2,"Duke","ACC",54,"",1,23,"3 over 2"
"1571",1571,"26-Mar-09",2009,"16","West",3,"Missouri","SEC",102,2,"Memphis","Amer",91,"",1,11,"3 over 2"
"1572",1572,"26-Mar-09",2009,"16","West",1,"Connecticut","Amer",72,5,"Purdue","B10",60,"",-4,12,"1 over 5"
"1573",1573,"26-Mar-09",2009,"16","East",1,"Pittsburgh","ACC",60,4,"Xavier","BE",55,"",-3,5,"1 over 4"
"1574",1574,"27-Mar-09",2009,"16","Midwest",1,"Louisville","ACC",103,12,"Arizona","P12",64,"",-11,39,"1 over 12"
"1575",1575,"27-Mar-09",2009,"16","South",1,"North Carolina","ACC",98,4,"Gonzaga","WCC",77,"",-3,21,"1 over 4"
"1576",1576,"27-Mar-09",2009,"16","Midwest",2,"Michigan St.","B10",67,3,"Kansas","B12",62,"",-1,5,"2 over 3"
"1577",1577,"27-Mar-09",2009,"16","South",2,"Oklahoma","B12",84,3,"Syracuse","ACC",71,"",-1,13,"2 over 3"
"1578",1578,"28-Mar-09",2009,"8","West",1,"Connecticut","Amer",82,3,"Missouri","SEC",75,"",-2,7,"1 over 3"
"1579",1579,"28-Mar-09",2009,"8","East",3,"Villanova","BE",78,1,"Pittsburgh","ACC",76,"",2,2,"3 over 1"
"1580",1580,"29-Mar-09",2009,"8","Midwest",2,"Michigan St.","B10",64,1,"Louisville","ACC",52,"",1,12,"2 over 1"
"1581",1581,"29-Mar-09",2009,"8","South",1,"North Carolina","ACC",72,2,"Oklahoma","B12",60,"",-1,12,"1 over 2"
"1582",1582,"4-Apr-09",2009,"4","Final Four",2,"Michigan St.","B10",82,1,"Connecticut","Amer",73,"",1,9,"2 over 1"
"1583",1583,"4-Apr-09",2009,"4","Final Four",1,"North Carolina","ACC",83,3,"Villanova","BE",69,"",-2,14,"1 over 3"
"1584",1584,"6-Apr-09",2009,"Champ","Championship",1,"North Carolina","ACC",89,2,"Michigan St.","B10",72,"",-1,17,"1 over 2"
"1585",1585,"16-Mar-10",2010,"Play-in","South",16,"Arkansas Pine Bluff","SWAC",61,16,"Winthrop","BSth",44,"",0,17,"16 over 16"
"1586",1586,"18-Mar-10",2010,"64","East",1,"Kentucky","SEC",100,16,"East Tennessee St.","SC",71,"",-15,29,"1 over 16"
"1587",1587,"18-Mar-10",2010,"64","West",7,"BYU","WCC",99,10,"Florida","SEC",92,"2 OT",-3,7,"7 over 10"
"1588",1588,"18-Mar-10",2010,"64","Midwest",14,"Ohio","MAC",97,3,"Georgetown","BE",83,"",11,14,"14 over 3"
"1589",1589,"18-Mar-10",2010,"64","Midwest",1,"Kansas","B12",90,16,"Lehigh","Pat",74,"",-15,16,"1 over 16"
"1590",1590,"18-Mar-10",2010,"64","East",11,"Washington","P12",80,6,"Marquette","BE",78,"",5,2,"11 over 6"
"1591",1591,"18-Mar-10",2010,"64","East",3,"New Mexico","MWC",62,14,"Montana","BSky",57,"",-11,5,"3 over 14"
"1592",1592,"18-Mar-10",2010,"64","West",2,"Kansas St.","B12",82,15,"North Texas","CUSA",62,"",-13,20,"2 over 15"
"1593",1593,"18-Mar-10",2010,"64","South",11,"Old Dominion","CUSA",51,6,"Notre Dame","ACC",50,"",5,1,"11 over 6"
"1594",1594,"18-Mar-10",2010,"64","South",10,"Saint Mary's","WCC",80,7,"Richmond","A10",71,"",3,9,"10 over 7"
"1595",1595,"18-Mar-10",2010,"64","South",2,"Villanova","BE",73,15,"Robert Morris","NEC",70,"1 OT",-13,3,"2 over 15"
"1596",1596,"18-Mar-10",2010,"64","South",3,"Baylor","B12",68,14,"Sam Houston St.","Slnd",59,"",-11,9,"3 over 14"
"1597",1597,"18-Mar-10",2010,"64","Midwest",6,"Tennessee","SEC",62,11,"San Diego St.","MWC",59,"",-5,3,"6 over 11"
"1598",1598,"18-Mar-10",2010,"64","East",9,"Wake Forest","ACC",81,8,"Texas","B12",80,"1 OT",1,1,"9 over 8"
"1599",1599,"18-Mar-10",2010,"64","Midwest",9,"Northern Iowa","MVC",69,8,"UNLV","MWC",66,"",1,3,"9 over 8"
"1600",1600,"18-Mar-10",2010,"64","West",5,"Butler","BE",77,12,"UTEP","CUSA",59,"",-7,18,"5 over 12"
"1601",1601,"18-Mar-10",2010,"64","West",13,"Murray St.","OVC",66,4,"Vanderbilt","SEC",65,"",9,1,"13 over 4"
"1602",1602,"19-Mar-10",2010,"64","South",1,"Duke","ACC",73,16,"Arkansas Pine Bluff","SWAC",44,"",-15,29,"1 over 16"
"1603",1603,"19-Mar-10",2010,"64","East",10,"Missouri","SEC",86,7,"Clemson","ACC",78,"",3,8,"10 over 7"
"1604",1604,"19-Mar-10",2010,"64","West",8,"Gonzaga","WCC",67,9,"Florida St.","ACC",60,"",-1,7,"8 over 9"
"1605",1605,"19-Mar-10",2010,"64","Midwest",4,"Maryland","B10",89,13,"Houston","Amer",77,"",-9,12,"4 over 13"
"1606",1606,"19-Mar-10",2010,"64","South",8,"California","P12",77,9,"Louisville","ACC",62,"",-1,15,"8 over 9"
"1607",1607,"19-Mar-10",2010,"64","West",6,"Xavier","BE",65,11,"Minnesota","B10",54,"",-5,11,"6 over 11"
"1608",1608,"19-Mar-10",2010,"64","East",2,"West Virginia","B12",77,15,"Morgan St.","MEAC",50,"",-13,27,"2 over 15"
"1609",1609,"19-Mar-10",2010,"64","Midwest",5,"Michigan St.","B10",70,12,"New Mexico St.","WAC",67,"",-7,3,"5 over 12"
"1610",1610,"19-Mar-10",2010,"64","West",3,"Pittsburgh","ACC",89,14,"Oakland","Horz",66,"",-11,23,"3 over 14"
"1611",1611,"19-Mar-10",2010,"64","Midwest",10,"Georgia Tech","ACC",64,7,"Oklahoma St.","B12",59,"",3,5,"10 over 7"
"1612",1612,"19-Mar-10",2010,"64","South",4,"Purdue","B10",72,13,"Siena","MAAC",64,"",-9,8,"4 over 13"
"1613",1613,"19-Mar-10",2010,"64","East",12,"Cornell","Ivy",78,5,"Temple","Amer",65,"",7,13,"12 over 5"
"1614",1614,"19-Mar-10",2010,"64","Midwest",2,"Ohio St.","B10",68,15,"UC Santa Barbara","BW",51,"",-13,17,"2 over 15"
"1615",1615,"19-Mar-10",2010,"64","South",5,"Texas A&M","SEC",69,12,"Utah St.","MWC",53,"",-7,16,"5 over 12"
"1616",1616,"19-Mar-10",2010,"64","West",1,"Syracuse","ACC",79,16,"Vermont","AE",56,"",-15,23,"1 over 16"
"1617",1617,"19-Mar-10",2010,"64","East",4,"Wisconsin","B10",53,13,"Wofford","SC",49,"",-9,4,"4 over 13"
"1618",1618,"20-Mar-10",2010,"32","West",2,"Kansas St.","B12",84,7,"BYU","WCC",72,"",-5,12,"2 over 7"
"1619",1619,"20-Mar-10",2010,"32","Midwest",9,"Northern Iowa","MVC",69,1,"Kansas","B12",67,"",8,2,"9 over 1"
"1620",1620,"20-Mar-10",2010,"32","West",5,"Butler","BE",54,13,"Murray St.","OVC",52,"",-8,2,"5 over 13"
"1621",1621,"20-Mar-10",2010,"32","East",11,"Washington","P12",82,3,"New Mexico","MWC",64,"",8,18,"11 over 3"
"1622",1622,"20-Mar-10",2010,"32","Midwest",6,"Tennessee","SEC",83,14,"Ohio","MAC",68,"",-8,15,"6 over 14"
"1623",1623,"20-Mar-10",2010,"32","South",3,"Baylor","B12",76,11,"Old Dominion","CUSA",68,"",-8,8,"3 over 11"
"1624",1624,"20-Mar-10",2010,"32","South",10,"Saint Mary's","WCC",75,2,"Villanova","BE",68,"",8,7,"10 over 2"
"1625",1625,"20-Mar-10",2010,"32","East",1,"Kentucky","SEC",90,9,"Wake Forest","ACC",60,"",-8,30,"1 over 9"
"1626",1626,"21-Mar-10",2010,"32","South",1,"Duke","ACC",68,8,"California","P12",53,"",-7,15,"1 over 8"
"1627",1627,"21-Mar-10",2010,"32","Midwest",2,"Ohio St.","B10",75,10,"Georgia Tech","ACC",66,"",-8,9,"2 over 10"
"1628",1628,"21-Mar-10",2010,"32","West",1,"Syracuse","ACC",87,8,"Gonzaga","WCC",65,"",-7,22,"1 over 8"
"1629",1629,"21-Mar-10",2010,"32","Midwest",5,"Michigan St.","B10",85,4,"Maryland","B10",83,"",1,2,"5 over 4"
"1630",1630,"21-Mar-10",2010,"32","East",2,"West Virginia","B12",68,10,"Missouri","SEC",59,"",-8,9,"2 over 10"
"1631",1631,"21-Mar-10",2010,"32","West",6,"Xavier","BE",71,3,"Pittsburgh","ACC",68,"",3,3,"6 over 3"
"1632",1632,"21-Mar-10",2010,"32","South",4,"Purdue","B10",63,5,"Texas A&M","SEC",61,"1 OT",-1,2,"4 over 5"
"1633",1633,"21-Mar-10",2010,"32","East",12,"Cornell","Ivy",87,4,"Wisconsin","B10",69,"",8,18,"12 over 4"
"1634",1634,"25-Mar-10",2010,"16","East",1,"Kentucky","SEC",62,12,"Cornell","Ivy",45,"",-11,17,"1 over 12"
"1635",1635,"25-Mar-10",2010,"16","West",5,"Butler","BE",63,1,"Syracuse","ACC",59,"",4,4,"5 over 1"
"1636",1636,"25-Mar-10",2010,"16","East",2,"West Virginia","B12",69,11,"Washington","P12",56,"",-9,13,"2 over 11"
"1637",1637,"25-Mar-10",2010,"16","West",2,"Kansas St.","B12",101,6,"Xavier","BE",96,"2 OT",-4,5,"2 over 6"
"1638",1638,"26-Mar-10",2010,"16","Midwest",5,"Michigan St.","B10",59,9,"Northern Iowa","MVC",52,"",-4,7,"5 over 9"
"1639",1639,"26-Mar-10",2010,"16","Midwest",6,"Tennessee","SEC",76,2,"Ohio St.","B10",73,"",4,3,"6 over 2"
"1640",1640,"26-Mar-10",2010,"16","South",1,"Duke","ACC",70,4,"Purdue","B10",57,"",-3,13,"1 over 4"
"1641",1641,"26-Mar-10",2010,"16","South",3,"Baylor","B12",72,10,"Saint Mary's","WCC",49,"",-7,23,"3 over 10"
"1642",1642,"27-Mar-10",2010,"8","West",5,"Butler","BE",63,2,"Kansas St.","B12",56,"",3,7,"5 over 2"
"1643",1643,"27-Mar-10",2010,"8","East",2,"West Virginia","B12",73,1,"Kentucky","SEC",66,"",1,7,"2 over 1"
"1644",1644,"28-Mar-10",2010,"8","South",1,"Duke","ACC",78,3,"Baylor","B12",71,"",-2,7,"1 over 3"
"1645",1645,"28-Mar-10",2010,"8","Midwest",5,"Michigan St.","B10",70,6,"Tennessee","SEC",69,"",-1,1,"5 over 6"
"1646",1646,"3-Apr-10",2010,"4","Final Four",5,"Butler","BE",52,5,"Michigan St.","B10",50,"",0,2,"5 over 5"
"1647",1647,"3-Apr-10",2010,"4","Final Four",1,"Duke","ACC",78,2,"West Virginia","B12",57,"",-1,21,"1 over 2"
"1648",1648,"5-Apr-10",2010,"Champ","Championship",1,"Duke","ACC",61,5,"Butler","BE",59,"",-4,2,"1 over 5"
"1649",1649,"15-Mar-11",2011,"Play-in","Southeast",16,"UNC Asheville","BSth",81,16,"Arkansas Little Rock","SB",77,"1 OT",0,4,"16 over 16"
"1650",1650,"15-Mar-11",2011,"Play-in","East",12,"Clemson","ACC",70,12,"UAB","CUSA",52,"",0,18,"12 over 12"
"1651",1651,"16-Mar-11",2011,"Play-in","East",16,"UTSA","CUSA",70,16,"Alabama St.","SWAC",61,"",0,9,"16 over 16"
"1652",1652,"16-Mar-11",2011,"Play-in","Southwest",11,"VCU","A10",59,11,"USC","P12",46,"",0,13,"11 over 11"
"1653",1653,"17-Mar-11",2011,"64","Southeast",4,"Wisconsin","B10",72,13,"Belmont","OVC",58,"",-9,14,"4 over 13"
"1654",1654,"17-Mar-11",2011,"64","West",3,"Connecticut","Amer",81,14,"Bucknell","Pat",52,"",-11,29,"3 over 14"
"1655",1655,"17-Mar-11",2011,"64","East",5,"West Virginia","B12",84,12,"Clemson","ACC",76,"",-7,8,"5 over 12"
"1656",1656,"17-Mar-11",2011,"64","Southwest",13,"Morehead St.","OVC",62,4,"Louisville","ACC",61,"",9,1,"13 over 4"
"1657",1657,"17-Mar-11",2011,"64","Southeast",7,"UCLA","P12",78,10,"Michigan St.","B10",76,"",-3,2,"7 over 10"
"1658",1658,"17-Mar-11",2011,"64","West",6,"Cincinnati","Amer",78,11,"Missouri","SEC",63,"",-5,15,"6 over 11"
"1659",1659,"17-Mar-11",2011,"64","West",2,"San Diego St.","MWC",68,15,"Northern Colorado","BSky",50,"",-13,18,"2 over 15"
"1660",1660,"17-Mar-11",2011,"64","Southeast",8,"Butler","BE",60,9,"Old Dominion","CUSA",58,"",-1,2,"8 over 9"
"1661",1661,"17-Mar-11",2011,"64","West",7,"Temple","Amer",66,10,"Penn St.","B10",64,"",-3,2,"7 over 10"
"1662",1662,"17-Mar-11",2011,"64","East",4,"Kentucky","SEC",59,13,"Princeton","Ivy",57,"",-9,2,"4 over 13"
"1663",1663,"17-Mar-11",2011,"64","Southeast",11,"Gonzaga","WCC",86,6,"St. John's","BE",71,"",5,15,"11 over 6"
"1664",1664,"17-Mar-11",2011,"64","Southeast",2,"Florida","SEC",79,15,"UC Santa Barbara","BW",51,"",-13,28,"2 over 15"
"1665",1665,"17-Mar-11",2011,"64","Southeast",1,"Pittsburgh","ACC",74,16,"UNC Asheville","BSth",51,"",-15,23,"1 over 16"
"1666",1666,"17-Mar-11",2011,"64","Southeast",5,"Kansas St.","B12",73,12,"Utah St.","MWC",68,"",-7,5,"5 over 12"
"1667",1667,"17-Mar-11",2011,"64","Southwest",12,"Richmond","A10",69,5,"Vanderbilt","SEC",66,"",7,3,"12 over 5"
"1668",1668,"17-Mar-11",2011,"64","Southeast",3,"BYU","WCC",74,14,"Wofford","SC",66,"",-11,8,"3 over 14"
"1669",1669,"18-Mar-11",2011,"64","Southwest",2,"Notre Dame","ACC",69,15,"Akron","MAC",56,"",-13,13,"2 over 15"
"1670",1670,"18-Mar-11",2011,"64","Southwest",1,"Kansas","B12",72,16,"Boston University","Pat",53,"",-15,19,"1 over 16"
"1671",1671,"18-Mar-11",2011,"64","Southwest",11,"VCU","A10",74,6,"Georgetown","BE",56,"",5,18,"11 over 6"
"1672",1672,"18-Mar-11",2011,"64","East",7,"Washington","P12",68,10,"Georgia","SEC",65,"",-3,3,"7 over 10"
"1673",1673,"18-Mar-11",2011,"64","West",1,"Duke","ACC",87,16,"Hampton","MEAC",45,"",-15,42,"1 over 16"
"1674",1674,"18-Mar-11",2011,"64","East",3,"Syracuse","ACC",77,14,"Indiana St.","MVC",60,"",-11,17,"3 over 14"
"1675",1675,"18-Mar-11",2011,"64","East",2,"North Carolina","ACC",102,15,"Long Island Brooklyn",NA,87,"",-13,15,"2 over 15"
"1676",1676,"18-Mar-11",2011,"64","West",5,"Arizona","P12",77,12,"Memphis","Amer",75,"",-7,2,"5 over 12"
"1677",1677,"18-Mar-11",2011,"64","West",4,"Texas","B12",85,13,"Oakland","Horz",81,"",-9,4,"4 over 13"
"1678",1678,"18-Mar-11",2011,"64","Southwest",3,"Purdue","B10",65,14,"St. Peter's",NA,43,"",-11,22,"3 over 14"
"1679",1679,"18-Mar-11",2011,"64","West",8,"Michigan","B10",75,9,"Tennessee","SEC",45,"",-1,30,"8 over 9"
"1680",1680,"18-Mar-11",2011,"64","Southwest",10,"Florida St.","ACC",57,7,"Texas A&M","SEC",50,"",3,7,"10 over 7"
"1681",1681,"18-Mar-11",2011,"64","Southwest",9,"Illinois","B10",73,8,"UNLV","MWC",62,"",1,11,"9 over 8"
"1682",1682,"18-Mar-11",2011,"64","East",1,"Ohio St.","B10",75,16,"UTSA","CUSA",46,"",-15,29,"1 over 16"
"1683",1683,"18-Mar-11",2011,"64","East",8,"George Mason","A10",61,9,"Villanova","BE",57,"",-1,4,"8 over 9"
"1684",1684,"18-Mar-11",2011,"64","East",11,"Marquette","BE",66,6,"Xavier","BE",55,"",5,11,"11 over 6"
"1685",1685,"19-Mar-11",2011,"32","West",3,"Connecticut","Amer",69,6,"Cincinnati","Amer",58,"",-3,11,"3 over 6"
"1686",1686,"19-Mar-11",2011,"32","Southeast",3,"BYU","WCC",89,11,"Gonzaga","WCC",67,"",-8,22,"3 over 11"
"1687",1687,"19-Mar-11",2011,"32","Southeast",4,"Wisconsin","B10",70,5,"Kansas St.","B12",65,"",-1,5,"4 over 5"
"1688",1688,"19-Mar-11",2011,"32","Southwest",12,"Richmond","A10",65,13,"Morehead St.","OVC",48,"",-1,17,"12 over 13"
"1689",1689,"19-Mar-11",2011,"32","Southeast",8,"Butler","BE",71,1,"Pittsburgh","ACC",70,"",7,1,"8 over 1"
"1690",1690,"19-Mar-11",2011,"32","West",2,"San Diego St.","MWC",71,7,"Temple","Amer",64,"2 OT",-5,7,"2 over 7"
"1691",1691,"19-Mar-11",2011,"32","Southeast",2,"Florida","SEC",73,7,"UCLA","P12",65,"",-5,8,"2 over 7"
"1692",1692,"19-Mar-11",2011,"32","East",4,"Kentucky","SEC",71,5,"West Virginia","B12",63,"",-1,8,"4 over 5"
"1693",1693,"20-Mar-11",2011,"32","East",1,"Ohio St.","B10",98,8,"George Mason","A10",66,"",-7,32,"1 over 8"
"1694",1694,"20-Mar-11",2011,"32","Southwest",1,"Kansas","B12",73,9,"Illinois","B10",59,"",-8,14,"1 over 9"
"1695",1695,"20-Mar-11",2011,"32","West",1,"Duke","ACC",73,8,"Michigan","B10",71,"",-7,2,"1 over 8"
"1696",1696,"20-Mar-11",2011,"32","Southwest",10,"Florida St.","ACC",71,2,"Notre Dame","ACC",57,"",8,14,"10 over 2"
"1697",1697,"20-Mar-11",2011,"32","Southwest",11,"VCU","A10",94,3,"Purdue","B10",76,"",8,18,"11 over 3"
"1698",1698,"20-Mar-11",2011,"32","East",11,"Marquette","BE",66,3,"Syracuse","ACC",62,"",8,4,"11 over 3"
"1699",1699,"20-Mar-11",2011,"32","West",5,"Arizona","P12",70,4,"Texas","B12",69,"",1,1,"5 over 4"
"1700",1700,"20-Mar-11",2011,"32","East",2,"North Carolina","ACC",86,7,"Washington","P12",83,"",-5,3,"2 over 7"
"1701",1701,"24-Mar-11",2011,"16","Southeast",2,"Florida","SEC",83,3,"BYU","WCC",74,"1 OT",-1,9,"2 over 3"
"1702",1702,"24-Mar-11",2011,"16","West",5,"Arizona","P12",93,1,"Duke","ACC",77,"",4,16,"5 over 1"
"1703",1703,"24-Mar-11",2011,"16","West",3,"Connecticut","Amer",74,2,"San Diego St.","MWC",67,"",1,7,"3 over 2"
"1704",1704,"24-Mar-11",2011,"16","Southeast",8,"Butler","BE",61,4,"Wisconsin","B10",54,"",4,7,"8 over 4"
"1705",1705,"25-Mar-11",2011,"16","Southwest",11,"VCU","A10",72,10,"Florida St.","ACC",71,"1 OT",1,1,"11 over 10"
"1706",1706,"25-Mar-11",2011,"16","East",2,"North Carolina","ACC",81,11,"Marquette","BE",63,"",-9,18,"2 over 11"
"1707",1707,"25-Mar-11",2011,"16","East",4,"Kentucky","SEC",62,1,"Ohio St.","B10",60,"",3,2,"4 over 1"
"1708",1708,"25-Mar-11",2011,"16","Southwest",1,"Kansas","B12",77,12,"Richmond","A10",57,"",-11,20,"1 over 12"
"1709",1709,"26-Mar-11",2011,"8","West",3,"Connecticut","Amer",65,5,"Arizona","P12",63,"",-2,2,"3 over 5"
"1710",1710,"26-Mar-11",2011,"8","Southeast",8,"Butler","BE",74,2,"Florida","SEC",71,"1 OT",6,3,"8 over 2"
"1711",1711,"27-Mar-11",2011,"8","Southwest",11,"VCU","A10",71,1,"Kansas","B12",61,"",10,10,"11 over 1"
"1712",1712,"27-Mar-11",2011,"8","East",4,"Kentucky","SEC",76,2,"North Carolina","ACC",69,"",2,7,"4 over 2"
"1713",1713,"2-Apr-11",2011,"4","Final Four",3,"Connecticut","Amer",56,4,"Kentucky","SEC",55,"",-1,1,"3 over 4"
"1714",1714,"2-Apr-11",2011,"4","Final Four",8,"Butler","BE",70,11,"VCU","A10",62,"",-3,8,"8 over 11"
"1715",1715,"4-Apr-11",2011,"Champ","Championship",3,"Connecticut","Amer",53,8,"Butler","BE",41,"",-5,12,"3 over 8"
"1716",1716,"13-Mar-12",2012,"Play-in","West",14,"BYU","WCC",78,14,"Iona","MAAC",72,"",0,6,"14 over 14"
"1717",1717,"13-Mar-12",2012,"Play-in","South",16,"Western Kentucky","CUSA",59,16,"Mississippi Valley",NA,58,"",0,1,"16 over 16"
"1718",1718,"14-Mar-12",2012,"Play-in","Midwest",12,"South Florida","Amer",65,12,"California","P12",54,"",0,11,"12 over 12"
"1719",1719,"14-Mar-12",2012,"Play-in","Midwest",16,"Vermont","AE",71,16,"Lamar","Slnd",59,"",0,12,"16 over 16"
"1720",1720,"15-Mar-12",2012,"64","West",3,"Marquette","BE",88,14,"BYU","WCC",68,"",-11,20,"3 over 14"
"1721",1721,"15-Mar-12",2012,"64","West",6,"Murray St.","OVC",58,11,"Colorado St.","MWC",41,"",-5,17,"6 over 11"
"1722",1722,"15-Mar-12",2012,"64","South",8,"Iowa St.","B12",77,9,"Connecticut","Amer",64,"",-1,13,"8 over 9"
"1723",1723,"15-Mar-12",2012,"64","West",4,"Louisville","ACC",69,13,"Davidson","A10",62,"",-9,7,"4 over 13"
"1724",1724,"15-Mar-12",2012,"64","East",5,"Vanderbilt","SEC",79,12,"Harvard","Ivy",70,"",-7,9,"5 over 12"
"1725",1725,"15-Mar-12",2012,"64","West",5,"New Mexico","MWC",75,12,"Long Beach St.","BW",68,"",-7,7,"5 over 12"
"1726",1726,"15-Mar-12",2012,"64","East",2,"Ohio St.","B10",78,15,"Loyola, Maryland",NA,59,"",-13,19,"2 over 15"
"1727",1727,"15-Mar-12",2012,"64","East",4,"Wisconsin","B10",73,13,"Montana","BSky",49,"",-9,24,"4 over 13"
"1728",1728,"15-Mar-12",2012,"64","South",4,"Indiana","B10",79,13,"New Mexico St.","WAC",66,"",-9,13,"4 over 13"
"1729",1729,"15-Mar-12",2012,"64","South",3,"Baylor","B12",68,14,"South Dakota St.","Sum",60,"",-11,8,"3 over 14"
"1730",1730,"15-Mar-12",2012,"64","East",8,"Kansas St.","B12",70,9,"Southern Mississippi",NA,64,"",-1,6,"8 over 9"
"1731",1731,"15-Mar-12",2012,"64","East",1,"Syracuse","ACC",72,16,"UNC Asheville","BSth",65,"",-15,7,"1 over 16"
"1732",1732,"15-Mar-12",2012,"64","South",11,"Colorado","P12",68,6,"UNLV","MWC",64,"",5,4,"11 over 6"
"1733",1733,"15-Mar-12",2012,"64","East",7,"Gonzaga","WCC",77,10,"West Virginia","B12",54,"",-3,23,"7 over 10"
"1734",1734,"15-Mar-12",2012,"64","South",1,"Kentucky","SEC",81,16,"Western Kentucky","CUSA",66,"",-15,15,"1 over 16"
"1735",1735,"15-Mar-12",2012,"64","South",12,"VCU","A10",62,5,"Wichita St.","MVC",59,"",7,3,"12 over 5"
"1736",1736,"16-Mar-12",2012,"64","Midwest",8,"Creighton","BE",58,9,"Alabama","SEC",57,"",-1,1,"8 over 9"
"1737",1737,"16-Mar-12",2012,"64","Midwest",3,"Georgetown","BE",74,14,"Belmont","OVC",59,"",-11,15,"3 over 14"
"1738",1738,"16-Mar-12",2012,"64","Midwest",2,"Kansas","B12",65,15,"Detroit","Horz",50,"",-13,15,"2 over 15"
"1739",1739,"16-Mar-12",2012,"64","South",15,"Lehigh","Pat",75,2,"Duke","ACC",70,"",13,5,"15 over 2"
"1740",1740,"16-Mar-12",2012,"64","West",1,"Michigan St.","B10",89,16,"Long Island Brooklyn",NA,67,"",-15,22,"1 over 16"
"1741",1741,"16-Mar-12",2012,"64","West",9,"Saint Louis","A10",61,8,"Memphis","Amer",54,"",1,7,"9 over 8"
"1742",1742,"16-Mar-12",2012,"64","Midwest",13,"Ohio","MAC",65,4,"Michigan","B10",60,"",9,5,"13 over 4"
"1743",1743,"16-Mar-12",2012,"64","West",15,"Norfolk St.","MEAC",86,2,"Missouri","SEC",84,"",13,2,"15 over 2"
"1744",1744,"16-Mar-12",2012,"64","South",10,"Xavier","BE",67,7,"Notre Dame","ACC",63,"",3,4,"10 over 7"
"1745",1745,"16-Mar-12",2012,"64","Midwest",10,"Purdue","B10",72,7,"Saint Mary's","WCC",69,"",3,3,"10 over 7"
"1746",1746,"16-Mar-12",2012,"64","Midwest",11,"North Carolina St.","ACC",79,6,"San Diego St.","MWC",65,"",5,14,"11 over 6"
"1747",1747,"16-Mar-12",2012,"64","East",3,"Florida St.","ACC",66,14,"St. Bonaventure","A10",63,"",-11,3,"3 over 14"
"1748",1748,"16-Mar-12",2012,"64","Midwest",12,"South Florida","Amer",58,5,"Temple","Amer",44,"",7,14,"12 over 5"
"1749",1749,"16-Mar-12",2012,"64","East",6,"Cincinnati","Amer",65,11,"Texas","B12",59,"",-5,6,"6 over 11"
"1750",1750,"16-Mar-12",2012,"64","Midwest",1,"North Carolina","ACC",77,16,"Vermont","AE",58,"",-15,19,"1 over 16"
"1751",1751,"16-Mar-12",2012,"64","West",7,"Florida","SEC",71,10,"Virginia","ACC",45,"",-3,26,"7 over 10"
"1752",1752,"17-Mar-12",2012,"32","South",3,"Baylor","B12",80,11,"Colorado","P12",63,"",-8,17,"3 over 11"
"1753",1753,"17-Mar-12",2012,"32","East",2,"Ohio St.","B10",73,7,"Gonzaga","WCC",66,"",-5,7,"2 over 7"
"1754",1754,"17-Mar-12",2012,"32","South",1,"Kentucky","SEC",87,8,"Iowa St.","B12",71,"",-7,16,"1 over 8"
"1755",1755,"17-Mar-12",2012,"32","East",1,"Syracuse","ACC",75,8,"Kansas St.","B12",59,"",-7,16,"1 over 8"
"1756",1756,"17-Mar-12",2012,"32","West",3,"Marquette","BE",62,6,"Murray St.","OVC",53,"",-3,9,"3 over 6"
"1757",1757,"17-Mar-12",2012,"32","West",4,"Louisville","ACC",59,5,"New Mexico","MWC",56,"",-1,3,"4 over 5"
"1758",1758,"17-Mar-12",2012,"32","East",4,"Wisconsin","B10",60,5,"Vanderbilt","SEC",57,"",-1,3,"4 over 5"
"1759",1759,"17-Mar-12",2012,"32","South",4,"Indiana","B10",63,12,"VCU","A10",61,"",-8,2,"4 over 12"
"1760",1760,"18-Mar-12",2012,"32","Midwest",1,"North Carolina","ACC",87,8,"Creighton","BE",73,"",-7,14,"1 over 8"
"1761",1761,"18-Mar-12",2012,"32","East",6,"Cincinnati","Amer",62,3,"Florida St.","ACC",56,"",3,6,"6 over 3"
"1762",1762,"18-Mar-12",2012,"32","Midwest",11,"North Carolina St.","ACC",66,3,"Georgetown","BE",63,"",8,3,"11 over 3"
"1763",1763,"18-Mar-12",2012,"32","South",10,"Xavier","BE",70,15,"Lehigh","Pat",58,"",-5,12,"10 over 15"
"1764",1764,"18-Mar-12",2012,"32","West",7,"Florida","SEC",84,15,"Norfolk St.","MEAC",50,"",-8,34,"7 over 15"
"1765",1765,"18-Mar-12",2012,"32","Midwest",2,"Kansas","B12",63,10,"Purdue","B10",60,"",-8,3,"2 over 10"
"1766",1766,"18-Mar-12",2012,"32","West",1,"Michigan St.","B10",65,9,"Saint Louis","A10",61,"",-8,4,"1 over 9"
"1767",1767,"18-Mar-12",2012,"32","Midwest",13,"Ohio","MAC",62,12,"South Florida","Amer",56,"",1,6,"13 over 12"
"1768",1768,"22-Mar-12",2012,"16","East",2,"Ohio St.","B10",81,6,"Cincinnati","Amer",66,"",-4,15,"2 over 6"
"1769",1769,"22-Mar-12",2012,"16","West",7,"Florida","SEC",68,3,"Marquette","BE",58,"",4,10,"7 over 3"
"1770",1770,"22-Mar-12",2012,"16","West",4,"Louisville","ACC",57,1,"Michigan St.","B10",44,"",3,13,"4 over 1"
"1771",1771,"22-Mar-12",2012,"16","East",1,"Syracuse","ACC",64,4,"Wisconsin","B10",63,"",-3,1,"1 over 4"
"1772",1772,"23-Mar-12",2012,"16","South",1,"Kentucky","SEC",102,4,"Indiana","B10",90,"",-3,12,"1 over 4"
"1773",1773,"23-Mar-12",2012,"16","Midwest",2,"Kansas","B12",60,11,"North Carolina St.","ACC",57,"",-9,3,"2 over 11"
"1774",1774,"23-Mar-12",2012,"16","Midwest",1,"North Carolina","ACC",73,13,"Ohio","MAC",65,"1 OT",-12,8,"1 over 13"
"1775",1775,"23-Mar-12",2012,"16","South",3,"Baylor","B12",75,10,"Xavier","BE",70,"",-7,5,"3 over 10"
"1776",1776,"24-Mar-12",2012,"8","West",4,"Louisville","ACC",72,7,"Florida","SEC",68,"",-3,4,"4 over 7"
"1777",1777,"24-Mar-12",2012,"8","East",2,"Ohio St.","B10",77,1,"Syracuse","ACC",70,"",1,7,"2 over 1"
"1778",1778,"25-Mar-12",2012,"8","South",1,"Kentucky","SEC",82,3,"Baylor","B12",70,"",-2,12,"1 over 3"
"1779",1779,"25-Mar-12",2012,"8","Midwest",2,"Kansas","B12",80,1,"North Carolina","ACC",67,"",1,13,"2 over 1"
"1780",1780,"31-Mar-12",2012,"4","Final Four",1,"Kentucky","SEC",69,4,"Louisville","ACC",61,"",-3,8,"1 over 4"
"1781",1781,"31-Mar-12",2012,"4","Final Four",2,"Kansas","B12",64,2,"Ohio St.","B10",62,"",0,2,"2 over 2"
"1782",1782,"2-Apr-12",2012,"Champ","Championship",1,"Kentucky","SEC",67,2,"Kansas","B12",59,"",-1,8,"1 over 2"
"1783",1783,"19-Mar-13",2013,"Play-in","Midwest",16,"North Carolina A&T","MEAC",73,16,"Liberty","BSth",72,"",0,1,"16 over 16"
"1784",1784,"19-Mar-13",2013,"Play-in","Midwest",11,"Saint Mary's","WCC",67,11,"Middle Tennessee","CUSA",54,"",0,13,"11 over 11"
"1785",1785,"20-Mar-13",2013,"Play-in","West",13,"La Salle","A10",80,13,"Boise St.","MWC",71,"",0,9,"13 over 13"
"1786",1786,"20-Mar-13",2013,"Play-in","East",16,"James Madison","CAA",68,16,"Long Island Brooklyn",NA,55,"",0,13,"16 over 16"
"1787",1787,"21-Mar-13",2013,"64","South",5,"VCU","A10",88,12,"Akron","MAC",42,"",-7,46,"5 over 12"
"1788",1788,"21-Mar-13",2013,"64","West",6,"Arizona","P12",81,11,"Belmont","OVC",64,"",-5,17,"6 over 11"
"1789",1789,"21-Mar-13",2013,"64","East",6,"Butler","BE",68,11,"Bucknell","Pat",56,"",-5,12,"6 over 11"
"1790",1790,"21-Mar-13",2013,"64","East",3,"Marquette","BE",59,14,"Davidson","A10",58,"",-11,1,"3 over 14"
"1791",1791,"21-Mar-13",2013,"64","Midwest",8,"Colorado St.","MWC",84,9,"Missouri","SEC",72,"",-1,12,"8 over 9"
"1792",1792,"21-Mar-13",2013,"64","East",4,"Syracuse","ACC",81,13,"Montana","BSky",34,"",-9,47,"4 over 13"
"1793",1793,"21-Mar-13",2013,"64","West",14,"Harvard","Ivy",68,3,"New Mexico","MWC",62,"",11,6,"14 over 3"
"1794",1794,"21-Mar-13",2013,"64","Midwest",4,"Saint Louis","A10",64,13,"New Mexico St.","WAC",44,"",-9,20,"4 over 13"
"1795",1795,"21-Mar-13",2013,"64","Midwest",1,"Louisville","ACC",79,16,"North Carolina A&T","MEAC",48,"",-15,31,"1 over 16"
"1796",1796,"21-Mar-13",2013,"64","Midwest",12,"Oregon","P12",68,5,"Oklahoma St.","B12",55,"",7,13,"12 over 5"
"1797",1797,"21-Mar-13",2013,"64","West",9,"Wichita St.","MVC",73,8,"Pittsburgh","ACC",55,"",1,18,"9 over 8"
"1798",1798,"21-Mar-13",2013,"64","Midwest",6,"Memphis","Amer",54,11,"Saint Mary's","WCC",52,"",-5,2,"6 over 11"
"1799",1799,"21-Mar-13",2013,"64","South",4,"Michigan","B10",71,13,"South Dakota St.","Sum",56,"",-9,15,"4 over 13"
"1800",1800,"21-Mar-13",2013,"64","West",1,"Gonzaga","WCC",64,16,"Southern","SWAC",58,"",-15,6,"1 over 16"
"1801",1801,"21-Mar-13",2013,"64","East",12,"California","P12",64,5,"UNLV","MWC",61,"",7,3,"12 over 5"
"1802",1802,"21-Mar-13",2013,"64","Midwest",3,"Michigan St.","B10",65,14,"Valparaiso","Horz",54,"",-11,11,"3 over 14"
"1803",1803,"22-Mar-13",2013,"64","Midwest",2,"Duke","ACC",73,15,"Albany","AE",61,"",-13,12,"2 over 15"
"1804",1804,"22-Mar-13",2013,"64","Midwest",7,"Creighton","BE",67,10,"Cincinnati","Amer",63,"",-3,4,"7 over 10"
"1805",1805,"22-Mar-13",2013,"64","East",7,"Illinois","B10",57,10,"Colorado","P12",49,"",-3,8,"7 over 10"
"1806",1806,"22-Mar-13",2013,"64","South",15,"Florida Gulf Coast","ASun",78,2,"Georgetown","BE",68,"",13,10,"15 over 2"
"1807",1807,"22-Mar-13",2013,"64","West",2,"Ohio St.","B10",95,15,"Iona","MAAC",70,"",-13,25,"2 over 15"
"1808",1808,"22-Mar-13",2013,"64","East",1,"Indiana","B10",83,16,"James Madison","CAA",62,"",-15,21,"1 over 16"
"1809",1809,"22-Mar-13",2013,"64","West",13,"La Salle","A10",63,4,"Kansas St.","B12",61,"",9,2,"13 over 4"
"1810",1810,"22-Mar-13",2013,"64","East",9,"Temple","Amer",76,8,"North Carolina St.","ACC",72,"",1,4,"9 over 8"
"1811",1811,"22-Mar-13",2013,"64","South",3,"Florida","SEC",79,14,"Northwestern St.","Slnd",47,"",-11,32,"3 over 14"
"1812",1812,"22-Mar-13",2013,"64","West",10,"Iowa St.","B12",76,7,"Notre Dame","ACC",58,"",3,18,"10 over 7"
"1813",1813,"22-Mar-13",2013,"64","South",7,"San Diego St.","MWC",70,10,"Oklahoma","B12",55,"",-3,15,"7 over 10"
"1814",1814,"22-Mar-13",2013,"64","East",2,"Miami FL","ACC",78,15,"Pacific","WCC",49,"",-13,29,"2 over 15"
"1815",1815,"22-Mar-13",2013,"64","South",11,"Minnesota","B10",83,6,"UCLA","P12",63,"",5,20,"11 over 6"
"1816",1816,"22-Mar-13",2013,"64","South",8,"North Carolina","ACC",78,9,"Villanova","BE",71,"",-1,7,"8 over 9"
"1817",1817,"22-Mar-13",2013,"64","South",1,"Kansas","B12",64,16,"Western Kentucky","CUSA",57,"",-15,7,"1 over 16"
"1818",1818,"22-Mar-13",2013,"64","West",12,"Mississippi","SEC",57,5,"Wisconsin","B10",46,"",7,11,"12 over 5"
"1819",1819,"23-Mar-13",2013,"32","East",3,"Marquette","BE",74,6,"Butler","BE",72,"",-3,2,"3 over 6"
"1820",1820,"23-Mar-13",2013,"32","East",4,"Syracuse","ACC",66,12,"California","P12",60,"",-8,6,"4 over 12"
"1821",1821,"23-Mar-13",2013,"32","Midwest",1,"Louisville","ACC",82,8,"Colorado St.","MWC",56,"",-7,26,"1 over 8"
"1822",1822,"23-Mar-13",2013,"32","West",9,"Wichita St.","MVC",76,1,"Gonzaga","WCC",70,"",8,6,"9 over 1"
"1823",1823,"23-Mar-13",2013,"32","West",6,"Arizona","P12",74,14,"Harvard","Ivy",51,"",-8,23,"6 over 14"
"1824",1824,"23-Mar-13",2013,"32","Midwest",3,"Michigan St.","B10",70,6,"Memphis","Amer",48,"",-3,22,"3 over 6"
"1825",1825,"23-Mar-13",2013,"32","Midwest",12,"Oregon","P12",74,4,"Saint Louis","A10",57,"",8,17,"12 over 4"
"1826",1826,"23-Mar-13",2013,"32","South",4,"Michigan","B10",78,5,"VCU","A10",53,"",-1,25,"4 over 5"
"1827",1827,"24-Mar-13",2013,"32","Midwest",2,"Duke","ACC",66,7,"Creighton","BE",50,"",-5,16,"2 over 7"
"1828",1828,"24-Mar-13",2013,"32","East",2,"Miami FL","ACC",63,7,"Illinois","B10",59,"",-5,4,"2 over 7"
"1829",1829,"24-Mar-13",2013,"32","West",2,"Ohio St.","B10",78,10,"Iowa St.","B12",75,"",-8,3,"2 over 10"
"1830",1830,"24-Mar-13",2013,"32","South",3,"Florida","SEC",78,11,"Minnesota","B10",64,"",-8,14,"3 over 11"
"1831",1831,"24-Mar-13",2013,"32","West",13,"La Salle","A10",76,12,"Mississippi","SEC",74,"",1,2,"13 over 12"
"1832",1832,"24-Mar-13",2013,"32","South",1,"Kansas","B12",70,8,"North Carolina","ACC",58,"",-7,12,"1 over 8"
"1833",1833,"24-Mar-13",2013,"32","South",15,"Florida Gulf Coast","ASun",81,7,"San Diego St.","MWC",71,"",8,10,"15 over 7"
"1834",1834,"24-Mar-13",2013,"32","East",1,"Indiana","B10",58,9,"Temple","Amer",52,"",-8,6,"1 over 9"
"1835",1835,"28-Mar-13",2013,"16","West",2,"Ohio St.","B10",73,6,"Arizona","P12",70,"",-4,3,"2 over 6"
"1836",1836,"28-Mar-13",2013,"16","East",4,"Syracuse","ACC",61,1,"Indiana","B10",50,"",3,11,"4 over 1"
"1837",1837,"28-Mar-13",2013,"16","West",9,"Wichita St.","MVC",72,13,"La Salle","A10",58,"",-4,14,"9 over 13"
"1838",1838,"28-Mar-13",2013,"16","East",3,"Marquette","BE",71,2,"Miami FL","ACC",61,"",1,10,"3 over 2"
"1839",1839,"29-Mar-13",2013,"16","South",3,"Florida","SEC",62,15,"Florida Gulf Coast","ASun",50,"",-12,12,"3 over 15"
"1840",1840,"29-Mar-13",2013,"16","South",4,"Michigan","B10",87,1,"Kansas","B12",85,"1 OT",3,2,"4 over 1"
"1841",1841,"29-Mar-13",2013,"16","Midwest",2,"Duke","ACC",71,3,"Michigan St.","B10",61,"",-1,10,"2 over 3"
"1842",1842,"29-Mar-13",2013,"16","Midwest",1,"Louisville","ACC",77,12,"Oregon","P12",69,"",-11,8,"1 over 12"
"1843",1843,"30-Mar-13",2013,"8","East",4,"Syracuse","ACC",55,3,"Marquette","BE",39,"",1,16,"4 over 3"
"1844",1844,"30-Mar-13",2013,"8","West",9,"Wichita St.","MVC",70,2,"Ohio St.","B10",66,"",7,4,"9 over 2"
"1845",1845,"31-Mar-13",2013,"8","Midwest",1,"Louisville","ACC",85,2,"Duke","ACC",63,"",-1,22,"1 over 2"
"1846",1846,"31-Mar-13",2013,"8","South",4,"Michigan","B10",79,3,"Florida","SEC",59,"",1,20,"4 over 3"
"1847",1847,"6-Apr-13",2013,"4","Final Four",4,"Michigan","B10",61,4,"Syracuse","ACC",56,"",0,5,"4 over 4"
"1848",1848,"6-Apr-13",2013,"4","Final Four",1,"Louisville","ACC",72,9,"Wichita St.","MVC",68,"",-8,4,"1 over 9"
"1849",1849,"8-Apr-13",2013,"Champ","",1,"Louisville","ACC",82,4,"Michigan","B10",76,"",-3,6,"1 over 4"
"1850",1850,"18-Mar-14",2014,"Play-in","South",16,"Albany","AE",71,16,"Mount St. Mary's","NEC",64,"",0,7,"16 over 16"
"1851",1851,"18-Mar-14",2014,"Play-in","Midwest",12,"North Carolina St.","ACC",74,12,"Xavier","BE",59,"",0,15,"12 over 12"
"1852",1852,"19-Mar-14",2014,"Play-in","Midwest",11,"Tennessee","SEC",78,11,"Iowa","B10",65,"1 OT",0,13,"11 over 11"
"1853",1853,"19-Mar-14",2014,"Play-in","Midwest",16,"Cal Poly","BW",81,16,"Texas Southern","SWAC",69,"",0,12,"16 over 16"
"1854",1854,"20-Mar-14",2014,"64","South",1,"Florida","SEC",67,16,"Albany","AE",55,"",-15,12,"1 over 16"
"1855",1855,"20-Mar-14",2014,"64","West",2,"Wisconsin","B10",75,15,"American","Pat",35,"",-13,40,"2 over 15"
"1856",1856,"20-Mar-14",2014,"64","Midwest",7,"Texas","B12",87,10,"Arizona St.","P12",85,"",-3,2,"7 over 10"
"1857",1857,"20-Mar-14",2014,"64","West",7,"Oregon","P12",87,10,"BYU","WCC",68,"",-3,19,"7 over 10"
"1858",1858,"20-Mar-14",2014,"64","East",12,"Harvard","Ivy",61,5,"Cincinnati","Amer",57,"",7,4,"12 over 5"
"1859",1859,"20-Mar-14",2014,"64","South",9,"Pittsburgh","ACC",77,8,"Colorado","P12",48,"",1,29,"9 over 8"
"1860",1860,"20-Mar-14",2014,"64","East",4,"Michigan St.","B10",93,13,"Delaware","CAA",78,"",-9,15,"4 over 13"
"1861",1861,"20-Mar-14",2014,"64","Midwest",4,"Louisville","ACC",71,13,"Manhattan","MAAC",64,"",-9,7,"4 over 13"
"1862",1862,"20-Mar-14",2014,"64","East",2,"Villanova","BE",73,15,"Milwaukee","Horz",53,"",-13,20,"2 over 15"
"1863",1863,"20-Mar-14",2014,"64","West",4,"San Diego St.","MWC",73,13,"New Mexico St.","WAC",69,"1 OT",-9,4,"4 over 13"
"1864",1864,"20-Mar-14",2014,"64","Midwest",5,"Saint Louis","A10",83,12,"North Carolina St.","ACC",80,"1 OT",-7,3,"5 over 12"
"1865",1865,"20-Mar-14",2014,"64","South",11,"Dayton","A10",60,6,"Ohio St.","B10",59,"",5,1,"11 over 6"
"1866",1866,"20-Mar-14",2014,"64","West",12,"North Dakota St.","Sum",80,5,"Oklahoma","B12",75,"1 OT",7,5,"12 over 5"
"1867",1867,"20-Mar-14",2014,"64","East",7,"Connecticut","Amer",89,10,"Saint Joseph's","A10",81,"1 OT",-3,8,"7 over 10"
"1868",1868,"20-Mar-14",2014,"64","South",3,"Syracuse","ACC",77,14,"Western Michigan","MAC",53,"",-11,24,"3 over 14"
"1869",1869,"20-Mar-14",2014,"64","Midwest",2,"Michigan","B10",57,15,"Wofford","SC",40,"",-13,17,"2 over 15"
"1870",1870,"21-Mar-14",2014,"64","Midwest",1,"Wichita St.","MVC",64,16,"Cal Poly","BW",37,"",-15,27,"1 over 16"
"1871",1871,"21-Mar-14",2014,"64","East",1,"Virginia","ACC",70,16,"Coastal Carolina","SB",59,"",-15,11,"1 over 16"
"1872",1872,"21-Mar-14",2014,"64","Midwest",14,"Mercer","SC",78,3,"Duke","ACC",71,"",11,7,"14 over 3"
"1873",1873,"21-Mar-14",2014,"64","South",2,"Kansas","B12",80,15,"Eastern Kentucky","OVC",69,"",-13,11,"2 over 15"
"1874",1874,"21-Mar-14",2014,"64","East",8,"Memphis","Amer",71,9,"George Washington","A10",66,"",-1,5,"8 over 9"
"1875",1875,"21-Mar-14",2014,"64","Midwest",8,"Kentucky","SEC",56,9,"Kansas St.","B12",49,"",-1,7,"8 over 9"
"1876",1876,"21-Mar-14",2014,"64","West",3,"Creighton","BE",76,14,"Louisiana Lafayette","SB",66,"",-11,10,"3 over 14"
"1877",1877,"21-Mar-14",2014,"64","Midwest",11,"Tennessee","SEC",86,6,"Massachusetts","A10",67,"",5,19,"11 over 6"
"1878",1878,"21-Mar-14",2014,"64","West",6,"Baylor","B12",74,11,"Nebraska","B10",60,"",-5,14,"6 over 11"
"1879",1879,"21-Mar-14",2014,"64","South",10,"Stanford","P12",58,7,"New Mexico","MWC",53,"",3,5,"10 over 7"
"1880",1880,"21-Mar-14",2014,"64","East",3,"Iowa St.","B12",93,14,"North Carolina Central","MEAC",75,"",-11,18,"3 over 14"
"1881",1881,"21-Mar-14",2014,"64","West",8,"Gonzaga","WCC",85,9,"Oklahoma St.","B12",77,"",-1,8,"8 over 9"
"1882",1882,"21-Mar-14",2014,"64","East",6,"North Carolina","ACC",79,11,"Providence","BE",77,"",-5,2,"6 over 11"
"1883",1883,"21-Mar-14",2014,"64","South",4,"UCLA","P12",76,13,"Tulsa","Amer",59,"",-9,17,"4 over 13"
"1884",1884,"21-Mar-14",2014,"64","South",12,"Stephen F. Austin","Slnd",77,5,"VCU","A10",75,"1 OT",7,2,"12 over 5"
"1885",1885,"21-Mar-14",2014,"64","West",1,"Arizona","P12",68,16,"Weber St.","BSky",59,"",-15,9,"1 over 16"
"1886",1886,"22-Mar-14",2014,"32","East",4,"Michigan St.","B10",80,12,"Harvard","Ivy",73,"",-8,7,"4 over 12"
"1887",1887,"22-Mar-14",2014,"32","West",4,"San Diego St.","MWC",63,12,"North Dakota St.","Sum",44,"",-8,19,"4 over 12"
"1888",1888,"22-Mar-14",2014,"32","West",2,"Wisconsin","B10",85,7,"Oregon","P12",77,"",-5,8,"2 over 7"
"1889",1889,"22-Mar-14",2014,"32","South",1,"Florida","SEC",61,9,"Pittsburgh","ACC",45,"",-8,16,"1 over 9"
"1890",1890,"22-Mar-14",2014,"32","Midwest",4,"Louisville","ACC",66,5,"Saint Louis","A10",51,"",-1,15,"4 over 5"
"1891",1891,"22-Mar-14",2014,"32","South",11,"Dayton","A10",55,3,"Syracuse","ACC",53,"",8,2,"11 over 3"
"1892",1892,"22-Mar-14",2014,"32","Midwest",2,"Michigan","B10",79,7,"Texas","B12",65,"",-5,14,"2 over 7"
"1893",1893,"22-Mar-14",2014,"32","East",7,"Connecticut","Amer",77,2,"Villanova","BE",65,"",5,12,"7 over 2"
"1894",1894,"23-Mar-14",2014,"32","West",6,"Baylor","B12",85,3,"Creighton","BE",55,"",3,30,"6 over 3"
"1895",1895,"23-Mar-14",2014,"32","West",1,"Arizona","P12",84,8,"Gonzaga","WCC",61,"",-7,23,"1 over 8"
"1896",1896,"23-Mar-14",2014,"32","South",10,"Stanford","P12",60,2,"Kansas","B12",57,"",8,3,"10 over 2"
"1897",1897,"23-Mar-14",2014,"32","East",1,"Virginia","ACC",78,8,"Memphis","Amer",60,"",-7,18,"1 over 8"
"1898",1898,"23-Mar-14",2014,"32","Midwest",11,"Tennessee","SEC",83,14,"Mercer","SC",63,"",-3,20,"11 over 14"
"1899",1899,"23-Mar-14",2014,"32","East",3,"Iowa St.","B12",85,6,"North Carolina","ACC",83,"",-3,2,"3 over 6"
"1900",1900,"23-Mar-14",2014,"32","South",4,"UCLA","P12",77,12,"Stephen F. Austin","Slnd",60,"",-8,17,"4 over 12"
"1901",1901,"23-Mar-14",2014,"32","Midwest",8,"Kentucky","SEC",78,1,"Wichita St.","MVC",76,"",7,2,"8 over 1"
"1902",1902,"27-Mar-14",2014,"16","West",2,"Wisconsin","B10",69,6,"Baylor","B12",52,"",-4,17,"2 over 6"
"1903",1903,"27-Mar-14",2014,"16","West",1,"Arizona","P12",70,4,"San Diego St.","MWC",64,"",-3,6,"1 over 4"
"1904",1904,"27-Mar-14",2014,"16","South",11,"Dayton","A10",82,10,"Stanford","P12",72,"",1,10,"11 over 10"
"1905",1905,"27-Mar-14",2014,"16","South",1,"Florida","SEC",79,4,"UCLA","P12",68,"",-3,11,"1 over 4"
"1906",1906,"28-Mar-14",2014,"16","East",7,"Connecticut","Amer",81,3,"Iowa St.","B12",76,"",4,5,"7 over 3"
"1907",1907,"28-Mar-14",2014,"16","Midwest",8,"Kentucky","SEC",74,4,"Louisville","ACC",69,"",4,5,"8 over 4"
"1908",1908,"28-Mar-14",2014,"16","Midwest",2,"Michigan","B10",73,11,"Tennessee","SEC",71,"",-9,2,"2 over 11"
"1909",1909,"28-Mar-14",2014,"16","East",4,"Michigan St.","B10",61,1,"Virginia","ACC",59,"",3,2,"4 over 1"
"1910",1910,"29-Mar-14",2014,"8","West",2,"Wisconsin","B10",64,1,"Arizona","P12",63,"1 OT",1,1,"2 over 1"
"1911",1911,"29-Mar-14",2014,"8","South",1,"Florida","SEC",62,11,"Dayton","A10",52,"",-10,10,"1 over 11"
"1912",1912,"30-Mar-14",2014,"8","Midwest",8,"Kentucky","SEC",75,2,"Michigan","B10",72,"",6,3,"8 over 2"
"1913",1913,"30-Mar-14",2014,"8","East",7,"Connecticut","Amer",60,4,"Michigan St.","B10",54,"",3,6,"7 over 4"
"1914",1914,"5-Apr-14",2014,"4","Final Four",7,"Connecticut","Amer",63,1,"Florida","SEC",53,"",6,10,"7 over 1"
"1915",1915,"5-Apr-14",2014,"4","Final Four",8,"Kentucky","SEC",74,2,"Wisconsin","B10",73,"",6,1,"8 over 2"
"1916",1916,"7-Apr-14",2014,"Champ","",7,"Connecticut","Amer",60,8,"Kentucky","SEC",54,"",-1,6,"7 over 8"
"1917",1917,"17-Mar-15",2015,"Play-in","West",11,"Mississippi","SEC",94,11,"BYU","WCC",90,"",0,4,"11 over 11"
"1918",1918,"17-Mar-15",2015,"Play-in","Midwest",16,"Hampton","MEAC",74,16,"Manhattan","MAAC",64,"",0,10,"16 over 16"
"1919",1919,"18-Mar-15",2015,"Play-in","East",11,"Dayton","A10",56,11,"Boise St.","MWC",55,"",0,1,"11 over 11"
"1920",1920,"18-Mar-15",2015,"Play-in","South",16,"Robert Morris","NEC",81,16,"North Florida","ASun",77,"",0,4,"16 over 16"
"1921",1921,"19-Mar-15",2015,"64","West",14,"Georgia St.","SB",57,3,"Baylor","B12",56,"",11,1,"14 over 3"
"1922",1922,"19-Mar-15",2015,"64","South",4,"Georgetown","BE",84,13,"Eastern Washington","BSky",74,"",-9,10,"4 over 13"
"1923",1923,"19-Mar-15",2015,"64","Midwest",1,"Kentucky","SEC",79,16,"Hampton","MEAC",56,"",-15,23,"1 over 16"
"1924",1924,"19-Mar-15",2015,"64","West",4,"North Carolina","ACC",67,13,"Harvard","Ivy",65,"",-9,2,"4 over 13"
"1925",1925,"19-Mar-15",2015,"64","South",14,"UAB","CUSA",60,3,"Iowa St.","B12",59,"",11,1,"14 over 3"
"1926",1926,"19-Mar-15",2015,"64","East",1,"Villanova","BE",93,16,"Lafayette","Pat",52,"",-15,41,"1 over 16"
"1927",1927,"19-Mar-15",2015,"64","East",8,"North Carolina St.","ACC",66,9,"LSU","SEC",65,"",-1,1,"8 over 9"
"1928",1928,"19-Mar-15",2015,"64","West",6,"Xavier","BE",76,11,"Mississippi","SEC",57,"",-5,19,"6 over 11"
"1929",1929,"19-Mar-15",2015,"64","Midwest",3,"Notre Dame","ACC",69,14,"Northeastern","CAA",65,"",-11,4,"3 over 14"
"1930",1930,"19-Mar-15",2015,"64","Midwest",8,"Cincinnati","Amer",66,9,"Purdue","B10",65,"1 OT",-1,1,"8 over 9"
"1931",1931,"19-Mar-15",2015,"64","South",11,"UCLA","P12",60,6,"SMU","Amer",59,"",5,1,"11 over 6"
"1932",1932,"19-Mar-15",2015,"64","South",5,"Utah","P12",57,12,"Stephen F. Austin","Slnd",50,"",-7,7,"5 over 12"
"1933",1933,"19-Mar-15",2015,"64","Midwest",6,"Butler","BE",56,11,"Texas","B12",48,"",-5,8,"6 over 11"
"1934",1934,"19-Mar-15",2015,"64","West",2,"Arizona","P12",93,15,"Texas Southern","SWAC",72,"",-13,21,"2 over 15"
"1935",1935,"19-Mar-15",2015,"64","West",10,"Ohio St.","B10",75,7,"VCU","A10",72,"1 OT",3,3,"10 over 7"
"1936",1936,"19-Mar-15",2015,"64","West",5,"Arkansas","SEC",56,12,"Wofford","SC",53,"",-7,3,"5 over 12"
"1937",1937,"20-Mar-15",2015,"64","East",3,"Oklahoma","B12",69,14,"Albany","AE",60,"",-11,9,"3 over 14"
"1938",1938,"20-Mar-15",2015,"64","East",2,"Virginia","ACC",79,15,"Belmont","OVC",67,"",-13,12,"2 over 15"
"1939",1939,"20-Mar-15",2015,"64","Midwest",5,"West Virginia","B12",68,12,"Buffalo","MAC",62,"",-7,6,"5 over 12"
"1940",1940,"20-Mar-15",2015,"64","West",1,"Wisconsin","B10",86,16,"Coastal Carolina","SB",72,"",-15,14,"1 over 16"
"1941",1941,"20-Mar-15",2015,"64","South",7,"Iowa","B10",83,10,"Davidson","A10",52,"",-3,31,"7 over 10"
"1942",1942,"20-Mar-15",2015,"64","East",7,"Michigan St.","B10",70,10,"Georgia","SEC",63,"",-3,7,"7 over 10"
"1943",1943,"20-Mar-15",2015,"64","Midwest",7,"Wichita St.","MVC",81,10,"Indiana","B10",76,"",-3,5,"7 over 10"
"1944",1944,"20-Mar-15",2015,"64","Midwest",2,"Kansas","B12",75,15,"New Mexico St.","WAC",56,"",-13,19,"2 over 15"
"1945",1945,"20-Mar-15",2015,"64","South",2,"Gonzaga","WCC",86,15,"North Dakota St.","Sum",76,"",-13,10,"2 over 15"
"1946",1946,"20-Mar-15",2015,"64","West",8,"Oregon","P12",79,9,"Oklahoma St.","B12",73,"",-1,6,"8 over 9"
"1947",1947,"20-Mar-15",2015,"64","East",11,"Dayton","A10",66,6,"Providence","BE",53,"",5,13,"11 over 6"
"1948",1948,"20-Mar-15",2015,"64","South",1,"Duke","ACC",85,16,"Robert Morris","NEC",56,"",-15,29,"1 over 16"
"1949",1949,"20-Mar-15",2015,"64","South",8,"San Diego St.","MWC",76,9,"St. John's","BE",64,"",-1,12,"8 over 9"
"1950",1950,"20-Mar-15",2015,"64","East",4,"Louisville","ACC",57,13,"UC Irvine","BW",55,"",-9,2,"4 over 13"
"1951",1951,"20-Mar-15",2015,"64","Midwest",4,"Maryland","B10",65,13,"Valparaiso","Horz",62,"",-9,3,"4 over 13"
"1952",1952,"20-Mar-15",2015,"64","East",5,"Northern Iowa","MVC",71,12,"Wyoming","MWC",54,"",-7,17,"5 over 12"
"1953",1953,"21-Mar-15",2015,"32","West",4,"North Carolina","ACC",87,5,"Arkansas","SEC",78,"",-1,9,"4 over 5"
"1954",1954,"21-Mar-15",2015,"32","Midwest",3,"Notre Dame","ACC",67,6,"Butler","BE",64,"1 OT",-3,3,"3 over 6"
"1955",1955,"21-Mar-15",2015,"32","Midwest",1,"Kentucky","SEC",64,8,"Cincinnati","Amer",51,"",-7,13,"1 over 8"
"1956",1956,"21-Mar-15",2015,"32","South",5,"Utah","P12",75,4,"Georgetown","BE",64,"",1,11,"5 over 4"
"1957",1957,"21-Mar-15",2015,"32","West",6,"Xavier","BE",75,14,"Georgia St.","SB",67,"",-8,8,"6 over 14"
"1958",1958,"21-Mar-15",2015,"32","West",2,"Arizona","P12",73,10,"Ohio St.","B10",58,"",-8,15,"2 over 10"
"1959",1959,"21-Mar-15",2015,"32","South",11,"UCLA","P12",92,14,"UAB","CUSA",75,"",-3,17,"11 over 14"
"1960",1960,"21-Mar-15",2015,"32","East",8,"North Carolina St.","ACC",71,1,"Villanova","BE",68,"",7,3,"8 over 1"
"1961",1961,"22-Mar-15",2015,"32","East",3,"Oklahoma","B12",72,11,"Dayton","A10",66,"",-8,6,"3 over 11"
"1962",1962,"22-Mar-15",2015,"32","South",2,"Gonzaga","WCC",87,7,"Iowa","B10",69,"",-5,18,"2 over 7"
"1963",1963,"22-Mar-15",2015,"32","Midwest",7,"Wichita St.","MVC",78,2,"Kansas","B12",65,"",5,13,"7 over 2"
"1964",1964,"22-Mar-15",2015,"32","Midwest",5,"West Virginia","B12",69,4,"Maryland","B10",59,"",1,10,"5 over 4"
"1965",1965,"22-Mar-15",2015,"32","East",4,"Louisville","ACC",66,5,"Northern Iowa","MVC",53,"",-1,13,"4 over 5"
"1966",1966,"22-Mar-15",2015,"32","West",1,"Wisconsin","B10",72,8,"Oregon","P12",65,"",-7,7,"1 over 8"
"1967",1967,"22-Mar-15",2015,"32","South",1,"Duke","ACC",68,8,"San Diego St.","MWC",49,"",-7,19,"1 over 8"
"1968",1968,"22-Mar-15",2015,"32","East",7,"Michigan St.","B10",60,2,"Virginia","ACC",54,"",5,6,"7 over 2"
"1969",1969,"26-Mar-15",2015,"16","West",1,"Wisconsin","B10",79,4,"North Carolina","ACC",72,"",-3,7,"1 over 4"
"1970",1970,"26-Mar-15",2015,"16","Midwest",1,"Kentucky","SEC",78,5,"West Virginia","B12",39,"",-4,39,"1 over 5"
"1971",1971,"26-Mar-15",2015,"16","Midwest",3,"Notre Dame","ACC",81,7,"Wichita St.","MVC",70,"",-4,11,"3 over 7"
"1972",1972,"26-Mar-15",2015,"16","West",2,"Arizona","P12",68,6,"Xavier","BE",60,"",-4,8,"2 over 6"
"1973",1973,"27-Mar-15",2015,"16","East",4,"Louisville","ACC",75,8,"North Carolina St.","ACC",65,"",-4,10,"4 over 8"
"1974",1974,"27-Mar-15",2015,"16","East",7,"Michigan St.","B10",62,3,"Oklahoma","B12",58,"",4,4,"7 over 3"
"1975",1975,"27-Mar-15",2015,"16","South",2,"Gonzaga","WCC",74,11,"UCLA","P12",62,"",-9,12,"2 over 11"
"1976",1976,"27-Mar-15",2015,"16","South",1,"Duke","ACC",63,5,"Utah","P12",57,"",-4,6,"1 over 5"
"1977",1977,"28-Mar-15",2015,"8","West",1,"Wisconsin","B10",85,2,"Arizona","P12",78,"",-1,7,"1 over 2"
"1978",1978,"28-Mar-15",2015,"8","Midwest",1,"Kentucky","SEC",68,3,"Notre Dame","ACC",66,"",-2,2,"1 over 3"
"1979",1979,"29-Mar-15",2015,"8","South",1,"Duke","ACC",66,2,"Gonzaga","WCC",52,"",-1,14,"1 over 2"
"1980",1980,"29-Mar-15",2015,"8","East",7,"Michigan St.","B10",76,4,"Louisville","ACC",70,"1 OT",3,6,"7 over 4"
"1981",1981,"4-Apr-15",2015,"4","Final Four",1,"Wisconsin","B10",71,1,"Kentucky","SEC",64,"",0,7,"1 over 1"
"1982",1982,"4-Apr-15",2015,"4","Final Four",1,"Duke","ACC",81,7,"Michigan St.","B10",61,"",-6,20,"1 over 7"
"1983",1983,"6-Apr-15",2015,"Champ","",1,"Duke","ACC",68,1,"Wisconsin","B10",63,"",0,5,"1 over 1"
"1984",1984,"15-Mar-16",2016,"Play-in","East",16,"Florida Gulf Coast","ASun",96,16,"Fairleigh Dickinson","NEC",65,"",0,31,"16 over 16"
"1985",1985,"15-Mar-16",2016,"Play-in","South",11,"Wichita St.","MVC",70,11,"Vanderbilt","SEC",50,"",0,20,"11 over 11"
"1986",1986,"16-Mar-16",2016,"Play-in","West",16,"Holy Cross","Pat",59,16,"Southern","SWAC",55,"",0,4,"16 over 16"
"1987",1987,"16-Mar-16",2016,"Play-in","East",11,"Michigan","B10",67,11,"Tulsa","Amer",62,"",0,5,"11 over 11"
"1988",1988,"17-Mar-16",2016,"64","South",11,"Wichita St.","MVC",65,6,"Arizona","P12",55,"",5,10,"11 over 6"
"1989",1989,"17-Mar-16",2016,"64","South",1,"Kansas","B12",105,16,"Austin Peay","OVC",79,"",-15,26,"1 over 16"
"1990",1990,"17-Mar-16",2016,"64","West",12,"Yale","Ivy",79,5,"Baylor","B12",75,"",7,4,"12 over 5"
"1991",1991,"17-Mar-16",2016,"64","South",3,"Miami FL","ACC",79,14,"Buffalo","MAC",72,"",-11,7,"3 over 14"
"1992",1992,"17-Mar-16",2016,"64","East",5,"Indiana","B10",99,12,"Chattanooga","SC",74,"",-7,25,"5 over 12"
"1993",1993,"17-Mar-16",2016,"64","South",9,"Connecticut","Amer",74,8,"Colorado","P12",67,"",1,7,"9 over 8"
"1994",1994,"17-Mar-16",2016,"64","East",1,"North Carolina","ACC",83,16,"Florida Gulf Coast","ASun",67,"",-15,16,"1 over 16"
"1995",1995,"17-Mar-16",2016,"64","Midwest",3,"Utah","P12",80,14,"Fresno St.","MWC",69,"",-11,11,"3 over 14"
"1996",1996,"17-Mar-16",2016,"64","Midwest",1,"Virginia","ACC",81,16,"Hampton","MEAC",45,"",-15,36,"1 over 16"
"1997",1997,"17-Mar-16",2016,"64","Midwest",4,"Iowa St.","B12",94,13,"Iona","MAAC",81,"",-9,13,"4 over 13"
"1998",1998,"17-Mar-16",2016,"64","Midwest",12,"Arkansas Little Rock","SB",85,5,"Purdue","B10",83,"2 OT",7,2,"12 over 5"
"1999",1999,"17-Mar-16",2016,"64","Midwest",11,"Gonzaga","WCC",68,6,"Seton Hall","BE",52,"",5,16,"11 over 6"
"2000",2000,"17-Mar-16",2016,"64","East",4,"Kentucky","SEC",85,13,"Stony Brook","AE",57,"",-9,28,"4 over 13"
"2001",2001,"17-Mar-16",2016,"64","Midwest",9,"Butler","BE",71,8,"Texas Tech","B12",61,"",1,10,"9 over 8"
"2002",2002,"17-Mar-16",2016,"64","West",4,"Duke","ACC",93,13,"UNC Wilmington","CAA",85,"",-9,8,"4 over 13"
"2003",2003,"17-Mar-16",2016,"64","East",9,"Providence","BE",70,8,"USC","P12",69,"",1,1,"9 over 8"
"2004",2004,"18-Mar-16",2016,"64","West",2,"Oklahoma","B12",82,15,"Cal St. Bakersfield","WAC",68,"",-13,14,"2 over 15"
"2005",2005,"18-Mar-16",2016,"64","South",13,"Hawaii","BW",77,4,"California","P12",66,"",9,11,"13 over 4"
"2006",2006,"18-Mar-16",2016,"64","West",8,"Saint Joseph's","A10",78,9,"Cincinnati","Amer",76,"",-1,2,"8 over 9"
"2007",2007,"18-Mar-16",2016,"64","Midwest",10,"Syracuse","ACC",70,7,"Dayton","A10",51,"",3,19,"10 over 7"
"2008",2008,"18-Mar-16",2016,"64","West",3,"Texas A&M","SEC",92,14,"Green Bay","Horz",65,"",-11,27,"3 over 14"
"2009",2009,"18-Mar-16",2016,"64","West",1,"Oregon","P12",91,16,"Holy Cross","Pat",52,"",-15,39,"1 over 16"
"2010",2010,"18-Mar-16",2016,"64","East",6,"Notre Dame","ACC",70,11,"Michigan","B10",63,"",-5,7,"6 over 11"
"2011",2011,"18-Mar-16",2016,"64","Midwest",15,"Middle Tennessee","CUSA",90,2,"Michigan St.","B10",81,"",13,9,"15 over 2"
"2012",2012,"18-Mar-16",2016,"64","West",10,"VCU","A10",75,7,"Oregon St.","P12",67,"",3,8,"10 over 7"
"2013",2013,"18-Mar-16",2016,"64","East",7,"Wisconsin","B10",47,10,"Pittsburgh","ACC",43,"",-3,4,"7 over 10"
"2014",2014,"18-Mar-16",2016,"64","South",5,"Maryland","B10",79,12,"South Dakota St.","Sum",74,"",-7,5,"5 over 12"
"2015",2015,"18-Mar-16",2016,"64","South",7,"Iowa","B10",72,10,"Temple","Amer",70,"1 OT",-3,2,"7 over 10"
"2016",2016,"18-Mar-16",2016,"64","West",11,"Northern Iowa","MVC",75,6,"Texas","B12",72,"",5,3,"11 over 6"
"2017",2017,"18-Mar-16",2016,"64","South",2,"Villanova","BE",86,15,"UNC Asheville","BSth",56,"",-13,30,"2 over 15"
"2018",2018,"18-Mar-16",2016,"64","East",2,"Xavier","BE",71,15,"Weber St.","BSky",53,"",-13,18,"2 over 15"
"2019",2019,"18-Mar-16",2016,"64","East",14,"Stephen F. Austin","Slnd",70,3,"West Virginia","B12",56,"",11,14,"14 over 3"
"2020",2020,"19-Mar-16",2016,"32","Midwest",4,"Iowa St.","B12",78,12,"Arkansas Little Rock","SB",61,"",-8,17,"4 over 12"
"2021",2021,"19-Mar-16",2016,"32","Midwest",1,"Virginia","ACC",77,9,"Butler","BE",69,"",-8,8,"1 over 9"
"2022",2022,"19-Mar-16",2016,"32","South",1,"Kansas","B12",73,9,"Connecticut","Amer",61,"",-8,12,"1 over 9"
"2023",2023,"19-Mar-16",2016,"32","East",5,"Indiana","B10",73,4,"Kentucky","SEC",67,"",1,6,"5 over 4"
"2024",2024,"19-Mar-16",2016,"32","East",1,"North Carolina","ACC",85,9,"Providence","BE",66,"",-8,19,"1 over 9"
"2025",2025,"19-Mar-16",2016,"32","Midwest",11,"Gonzaga","WCC",82,3,"Utah","P12",59,"",8,23,"11 over 3"
"2026",2026,"19-Mar-16",2016,"32","South",3,"Miami FL","ACC",65,11,"Wichita St.","MVC",57,"",-8,8,"3 over 11"
"2027",2027,"19-Mar-16",2016,"32","West",4,"Duke","ACC",71,12,"Yale","Ivy",64,"",-8,7,"4 over 12"
"2028",2028,"20-Mar-16",2016,"32","South",5,"Maryland","B10",73,13,"Hawaii","BW",60,"",-8,13,"5 over 13"
"2029",2029,"20-Mar-16",2016,"32","South",2,"Villanova","BE",87,7,"Iowa","B10",68,"",-5,19,"2 over 7"
"2030",2030,"20-Mar-16",2016,"32","Midwest",10,"Syracuse","ACC",75,15,"Middle Tennessee","CUSA",50,"",-5,25,"10 over 15"
"2031",2031,"20-Mar-16",2016,"32","West",3,"Texas A&M","SEC",92,11,"Northern Iowa","MVC",88,"2 OT",-8,4,"3 over 11"
"2032",2032,"20-Mar-16",2016,"32","West",1,"Oregon","P12",69,8,"Saint Joseph's","A10",64,"",-7,5,"1 over 8"
"2033",2033,"20-Mar-16",2016,"32","East",6,"Notre Dame","ACC",76,14,"Stephen F. Austin","Slnd",75,"",-8,1,"6 over 14"
"2034",2034,"20-Mar-16",2016,"32","West",2,"Oklahoma","B12",85,10,"VCU","A10",81,"",-8,4,"2 over 10"
"2035",2035,"20-Mar-16",2016,"32","East",7,"Wisconsin","B10",66,2,"Xavier","BE",63,"",5,3,"7 over 2"
"2036",2036,"24-Mar-16",2016,"16","West",1,"Oregon","P12",82,4,"Duke","ACC",68,"",-3,14,"1 over 4"
"2037",2037,"24-Mar-16",2016,"16","South",1,"Kansas","B12",79,5,"Maryland","B10",63,"",-4,16,"1 over 5"
"2038",2038,"24-Mar-16",2016,"16","South",2,"Villanova","BE",92,3,"Miami FL","ACC",69,"",-1,23,"2 over 3"
"2039",2039,"24-Mar-16",2016,"16","West",2,"Oklahoma","B12",77,3,"Texas A&M","SEC",63,"",-1,14,"2 over 3"
"2040",2040,"25-Mar-16",2016,"16","Midwest",10,"Syracuse","ACC",63,11,"Gonzaga","WCC",60,"",-1,3,"10 over 11"
"2041",2041,"25-Mar-16",2016,"16","East",1,"North Carolina","ACC",101,5,"Indiana","B10",86,"",-4,15,"1 over 5"
"2042",2042,"25-Mar-16",2016,"16","Midwest",1,"Virginia","ACC",84,4,"Iowa St.","B12",71,"",-3,13,"1 over 4"
"2043",2043,"25-Mar-16",2016,"16","East",6,"Notre Dame","ACC",61,7,"Wisconsin","B10",56,"",-1,5,"6 over 7"
"2044",2044,"26-Mar-16",2016,"8","South",2,"Villanova","BE",64,1,"Kansas","B12",59,"",1,5,"2 over 1"
"2045",2045,"26-Mar-16",2016,"8","West",2,"Oklahoma","B12",80,1,"Oregon","P12",68,"",1,12,"2 over 1"
"2046",2046,"27-Mar-16",2016,"8","East",1,"North Carolina","ACC",88,6,"Notre Dame","ACC",74,"",-5,14,"1 over 6"
"2047",2047,"27-Mar-16",2016,"8","Midwest",10,"Syracuse","ACC",68,1,"Virginia","ACC",62,"",9,6,"10 over 1"
"2048",2048,"2-Apr-16",2016,"4","Final Four",2,"Villanova","BE",95,2,"Oklahoma","B12",51,"",0,44,"2 over 2"
"2049",2049,"2-Apr-16",2016,"4","Final Four",1,"North Carolina","ACC",83,10,"Syracuse","ACC",66,"",-9,17,"1 over 10"
"2050",2050,"4-Apr-16",2016,"Champ","",2,"Villanova","BE",77,1,"North Carolina","ACC",74,"",1,3,"2 over 1"
"2051",2051,"14-Mar-17",2017,"Play-in","East",16,"Mount St. Mary's","NEC",67,16,"New Orleans","Slnd",66,"",0,1,"16 over 16"
"2052",2052,"14-Mar-17",2017,"Play-in","South",11,"Kansas St.","B12",95,11,"Wake Forest","ACC",88,"",0,7,"11 over 11"
"2053",2053,"15-Mar-17",2017,"Play-in","Midwest",16,"UC Davis","BW",67,16,"North Carolina Central","MEAC",63,"",0,4,"16 over 16"
"2054",2054,"15-Mar-17",2017,"Play-in","East",11,"USC","P12",75,11,"Providence","BE",71,"",0,4,"11 over 11"
"2055",2055,"16-Mar-17",2017,"64","West",4,"West Virginia","B12",86,13,"Bucknell","Pat",80,"",-9,6,"4 over 13"
"2056",2056,"16-Mar-17",2017,"64","East",4,"Florida","SEC",80,13,"East Tennessee St.","SC",65,"",-9,15,"4 over 13"
"2057",2057,"16-Mar-17",2017,"64","West",3,"Florida St.","ACC",86,14,"Florida Gulf Coast","ASun",80,"",-11,6,"3 over 14"
"2058",2058,"16-Mar-17",2017,"64","West",11,"Xavier","BE",76,6,"Maryland","B10",65,"",5,11,"11 over 6"
"2059",2059,"16-Mar-17",2017,"64","South",12,"Middle Tennessee","CUSA",81,5,"Minnesota","B10",72,"",7,9,"12 over 5"
"2060",2060,"16-Mar-17",2017,"64","East",1,"Villanova","BE",76,16,"Mount St. Mary's","NEC",56,"",-15,20,"1 over 16"
"2061",2061,"16-Mar-17",2017,"64","Midwest",5,"Iowa St.","B12",84,12,"Nevada","MWC",73,"",-7,11,"5 over 12"
"2062",2062,"16-Mar-17",2017,"64","West",2,"Arizona","P12",100,15,"North Dakota","BSky",82,"",-13,18,"2 over 15"
"2063",2063,"16-Mar-17",2017,"64","West",5,"Notre Dame","ACC",60,12,"Princeton","Ivy",58,"",-7,2,"5 over 12"
"2064",2064,"16-Mar-17",2017,"64","West",1,"Gonzaga","WCC",66,16,"San Diego St.","MWC",46,"",-15,20,"1 over 16"
"2065",2065,"16-Mar-17",2017,"64","East",5,"Virginia","ACC",76,12,"UNC Wilmington","CAA",71,"",-7,5,"5 over 12"
"2066",2066,"16-Mar-17",2017,"64","West",8,"Northwestern","B10",68,9,"Vanderbilt","SEC",66,"",-1,2,"8 over 9"
"2067",2067,"16-Mar-17",2017,"64","West",7,"Saint Mary's","WCC",85,10,"VCU","A10",77,"",-3,8,"7 over 10"
"2068",2068,"16-Mar-17",2017,"64","Midwest",4,"Purdue","B10",80,13,"Vermont","AE",70,"",-9,10,"4 over 13"
"2069",2069,"16-Mar-17",2017,"64","East",8,"Wisconsin","B10",84,9,"Virginia Tech","ACC",74,"",-1,10,"8 over 9"
"2070",2070,"16-Mar-17",2017,"64","South",4,"Butler","BE",76,13,"Winthrop","BSth",64,"",-9,12,"4 over 13"
"2071",2071,"17-Mar-17",2017,"64","Midwest",11,"Rhode Island","A10",84,6,"Creighton","BE",72,"",5,12,"11 over 6"
"2072",2072,"17-Mar-17",2017,"64","South",10,"Wichita St.","MVC",64,7,"Dayton","A10",58,"",3,6,"10 over 7"
"2073",2073,"17-Mar-17",2017,"64","Midwest",3,"Oregon","P12",93,14,"Iona","MAAC",77,"",-11,16,"3 over 14"
"2074",2074,"17-Mar-17",2017,"64","Midwest",2,"Louisville","ACC",78,15,"Jacksonville St.","OVC",63,"",-13,15,"2 over 15"
"2075",2075,"17-Mar-17",2017,"64","South",6,"Cincinnati","Amer",75,11,"Kansas St.","B12",61,"",-5,14,"6 over 11"
"2076",2076,"17-Mar-17",2017,"64","South",3,"UCLA","P12",97,14,"Kent St.","MAC",80,"",-11,17,"3 over 14"
"2077",2077,"17-Mar-17",2017,"64","East",7,"South Carolina","SEC",93,10,"Marquette","BE",73,"",-3,20,"7 over 10"
"2078",2078,"17-Mar-17",2017,"64","Midwest",9,"Michigan St.","B10",78,8,"Miami FL","ACC",58,"",1,20,"9 over 8"
"2079",2079,"17-Mar-17",2017,"64","East",3,"Baylor","B12",91,14,"New Mexico St.","WAC",73,"",-11,18,"3 over 14"
"2080",2080,"17-Mar-17",2017,"64","South",2,"Kentucky","SEC",79,15,"Northern Kentucky","Horz",70,"",-13,9,"2 over 15"
"2081",2081,"17-Mar-17",2017,"64","Midwest",7,"Michigan","B10",92,10,"Oklahoma St.","B12",91,"",-3,1,"7 over 10"
"2082",2082,"17-Mar-17",2017,"64","South",8,"Arkansas","SEC",77,9,"Seton Hall","BE",71,"",-1,6,"8 over 9"
"2083",2083,"17-Mar-17",2017,"64","East",11,"USC","P12",66,6,"SMU","Amer",65,"",5,1,"11 over 6"
"2084",2084,"17-Mar-17",2017,"64","South",1,"North Carolina","ACC",103,16,"Texas Southern","SWAC",64,"",-15,39,"1 over 16"
"2085",2085,"17-Mar-17",2017,"64","East",2,"Duke","ACC",87,15,"Troy","SB",65,"",-13,22,"2 over 15"
"2086",2086,"17-Mar-17",2017,"64","Midwest",1,"Kansas","B12",100,16,"UC Davis","BW",62,"",-15,38,"1 over 16"
"2087",2087,"18-Mar-17",2017,"32","West",11,"Xavier","BE",91,3,"Florida St.","ACC",66,"",8,25,"11 over 3"
"2088",2088,"18-Mar-17",2017,"32","Midwest",4,"Purdue","B10",80,5,"Iowa St.","B12",76,"",-1,4,"4 over 5"
"2089",2089,"18-Mar-17",2017,"32","South",4,"Butler","BE",74,12,"Middle Tennessee","CUSA",65,"",-8,9,"4 over 12"
"2090",2090,"18-Mar-17",2017,"32","West",1,"Gonzaga","WCC",79,8,"Northwestern","B10",73,"",-7,6,"1 over 8"
"2091",2091,"18-Mar-17",2017,"32","West",4,"West Virginia","B12",83,5,"Notre Dame","ACC",71,"",-1,12,"4 over 5"
"2092",2092,"18-Mar-17",2017,"32","West",2,"Arizona","P12",69,7,"Saint Mary's","WCC",60,"",-5,9,"2 over 7"
"2093",2093,"18-Mar-17",2017,"32","East",8,"Wisconsin","B10",65,1,"Villanova","BE",62,"",7,3,"8 over 1"
"2094",2094,"18-Mar-17",2017,"32","East",4,"Florida","SEC",65,5,"Virginia","ACC",39,"",-1,26,"4 over 5"
"2095",2095,"19-Mar-17",2017,"32","South",1,"North Carolina","ACC",72,8,"Arkansas","SEC",65,"",-7,7,"1 over 8"
"2096",2096,"19-Mar-17",2017,"32","South",3,"UCLA","P12",79,6,"Cincinnati","Amer",67,"",-3,12,"3 over 6"
"2097",2097,"19-Mar-17",2017,"32","East",7,"South Carolina","SEC",88,2,"Duke","ACC",81,"",5,7,"7 over 2"
"2098",2098,"19-Mar-17",2017,"32","Midwest",7,"Michigan","B10",73,2,"Louisville","ACC",69,"",5,4,"7 over 2"
"2099",2099,"19-Mar-17",2017,"32","Midwest",1,"Kansas","B12",90,9,"Michigan St.","B10",70,"",-8,20,"1 over 9"
"2100",2100,"19-Mar-17",2017,"32","Midwest",3,"Oregon","P12",75,11,"Rhode Island","A10",72,"",-8,3,"3 over 11"
"2101",2101,"19-Mar-17",2017,"32","East",3,"Baylor","B12",82,11,"USC","P12",78,"",-8,4,"3 over 11"
"2102",2102,"19-Mar-17",2017,"32","South",2,"Kentucky","SEC",65,10,"Wichita St.","MVC",62,"",-8,3,"2 over 10"
"2103",2103,"23-Mar-17",2017,"16","West",11,"Xavier","BE",73,2,"Arizona","P12",71,"",9,2,"11 over 2"
"2104",2104,"23-Mar-17",2017,"16","Midwest",3,"Oregon","P12",69,7,"Michigan","B10",68,"",-4,1,"3 over 7"
"2105",2105,"23-Mar-17",2017,"16","Midwest",1,"Kansas","B12",98,4,"Purdue","B10",66,"",-3,32,"1 over 4"
"2106",2106,"23-Mar-17",2017,"16","West",1,"Gonzaga","WCC",61,4,"West Virginia","B12",58,"",-3,3,"1 over 4"
"2107",2107,"24-Mar-17",2017,"16","East",7,"South Carolina","SEC",70,3,"Baylor","B12",50,"",4,20,"7 over 3"
"2108",2108,"24-Mar-17",2017,"16","South",1,"North Carolina","ACC",92,4,"Butler","BE",80,"",-3,12,"1 over 4"
"2109",2109,"24-Mar-17",2017,"16","South",2,"Kentucky","SEC",86,3,"UCLA","P12",75,"",-1,11,"2 over 3"
"2110",2110,"24-Mar-17",2017,"16","East",4,"Florida","SEC",84,8,"Wisconsin","B10",83,"1 OT",-4,1,"4 over 8"
"2111",2111,"25-Mar-17",2017,"8","Midwest",3,"Oregon","P12",74,1,"Kansas","B12",60,"",2,14,"3 over 1"
"2112",2112,"25-Mar-17",2017,"8","West",1,"Gonzaga","WCC",83,11,"Xavier","BE",59,"",-10,24,"1 over 11"
"2113",2113,"26-Mar-17",2017,"8","East",7,"South Carolina","SEC",77,4,"Florida","SEC",70,"",3,7,"7 over 4"
"2114",2114,"26-Mar-17",2017,"8","South",1,"North Carolina","ACC",75,2,"Kentucky","SEC",73,"",-1,2,"1 over 2"
"2115",2115,"1-Apr-17",2017,"4","",1,"North Carolina","ACC",77,3,"Oregon","P12",76,"",-2,1,"1 over 3"
"2116",2116,"1-Apr-17",2017,"4","",1,"Gonzaga","WCC",77,7,"South Carolina","SEC",73,"",-6,4,"1 over 7"
"2117",2117,"3-Apr-17",2017,"Champ","",1,"North Carolina","ACC",71,1,"Gonzaga","WCC",65,"",0,6,"1 over 1"
